прамінуць	p r a mʲ i n u t͡sʲ
млынішча	m ɫ ɨ nʲ i ʂ t͡ʂ a
страмчэй	s t r a m t͡ʂ ɛ j
выклічнік	v ɨ k lʲ i t͡ʂ nʲ i k
сказіць	s k a zʲ i t͡sʲ
змовіцца	z m ɔ vʲ i t͡sː a
звярзціся	zʲ vʲ a r zʲ t͡sʲ i sʲ a
лісіца	lʲ i sʲ i t͡s a
развярцець	r a zʲ vʲ a r t͡sʲ ɛ t͡sʲ
павярхоўны	p a vʲ a r x ɔ w n ɨ
цярпець	t͡sʲ a r pʲ ɛ t͡sʲ
самаабвінавачванне	s a m a a b vʲ i n a v a t͡ʂ v a nʲː ɛ
вакацыі	v a k a t͡s ɨ j i
патрапіць	p a t r a pʲ i t͡sʲ
дзівіць	d͡zʲ i vʲ i t͡sʲ
давернік	d a vʲ ɛ r nʲ i k
угін	u ɣʲ i n
пакалаціць	p a k a ɫ a t͡sʲ i t͡sʲ
пазачасавы	p a z a t͡ʂ a s a v ɨ
паадсоўваць	p a a d s ɔ w v a t͡sʲ
палёгка	p a lʲ ɔ ɣ k a
агародніна	a ɣ a r ɔ d nʲ i n a
палец	p a lʲ ɛ t͡s
панасвідроўваць	p a n a sʲ vʲ i d r ɔ w v a t͡sʲ
негасцінны	nʲ ɛ ɣ a sʲ t͡sʲ i nː ɨ
памыліцца	p a m ɨ lʲ i t͡sː a
прыблуда	p r ɨ b ɫ u d a
паўчварта	p a w t͡ʂ v a r t a
прарэх	p r a r ɛ x
шкарлятына	ʂ k a r lʲ a t ɨ n a
шпунт	ʂ p u n t
падтыннік	p a d t ɨ nʲː i k
пуд	p u d
паперапальваць	p a pʲ ɛ r a p a lʲ v a t͡sʲ
патанчэць	p a t a n t͡ʂ ɛ t͡sʲ
уцінак	u t͡sʲ i n a k
шчадроўка	ʂ t͡ʂ a d r ɔ w k a
келіх	kʲ ɛ lʲ i x
усушыць	u s u ʂ ɨ t͡sʲ
зганьбіць	z ɣ a nʲ bʲ i t͡sʲ
палагоднець	p a ɫ a ɣ ɔ d nʲ ɛ t͡sʲ
шыльда	ʂ ɨ lʲ d a
стухнуць	s t u x n u t͡sʲ
вышыннік	v ɨ ʂ ɨ nʲː i k
беларускамоўны	bʲ ɛ ɫ a r u s k a m ɔ w n ɨ
цагляны	t͡s a ɣ lʲ a n ɨ
словаўжыванне	s ɫ ɔ v a w ʐ ɨ v a nʲː ɛ
гранічны	ɣ r a nʲ i t͡ʂ n ɨ
руля	r u lʲ a
узяць	u zʲ a t͡sʲ
перасвідраваць	pʲ ɛ r a sʲ vʲ i d r a v a t͡sʲ
уцякач	u t͡sʲ a k a t͡ʂ
папрасвідроўваць	p a p r a sʲ vʲ i d r ɔ w v a t͡sʲ
кіраваць	kʲ i r a v a t͡sʲ
узрывальнік	u z r ɨ v a lʲ nʲ i k
спілоўка	sʲ pʲ i ɫ ɔ w k a
прагаманіць	p r a ɣ a m a nʲ i t͡sʲ
там	t a m
прыважыць	p r ɨ v a ʐ ɨ t͡sʲ
церабіць	t͡sʲ ɛ r a bʲ i t͡sʲ
вымавіць	v ɨ m a vʲ i t͡sʲ
рыбак	r ɨ b a k
торфанарыхтоўка	t ɔ r f a n a r ɨ x t ɔ w k a
жаўтакруг	ʐ a w t a k r u ɣ
цікаўны	t͡sʲ i k a w n ɨ
сівы	sʲ i v ɨ
лучнік	ɫ u t͡ʂ nʲ i k
слабы	s ɫ a b ɨ
узаемаадносіны	u z a j ɛ m a a d n ɔ sʲ i n ɨ
укарміць	u k a r mʲ i t͡sʲ
укаранець	u k a r a nʲ ɛ t͡sʲ
калісьці	k a lʲ i sʲ t͡sʲ i
смелы	sʲ mʲ ɛ ɫ ɨ
трошкі	t r ɔ ʂ kʲ i
пазмацоўваць	p a z m a t͡s ɔ w v a t͡sʲ
асмаліць	a s m a lʲ i t͡sʲ
кігікаць	kʲ i ɣʲ i k a t͡sʲ
папрадзёўбваць	p a p r a d͡zʲ ɔ w b v a t͡sʲ
пра	p r a
прасніца	p r a sʲ nʲ i t͡s a
згрэбці	z ɣ r ɛ b t͡sʲ i
спудзіць	s p u d͡zʲ i t͡sʲ
спякота	sʲ pʲ a k ɔ t a
раслінаводства	r a sʲ lʲ i n a v ɔ d s t v a
саматужнік	s a m a t u ʐ nʲ i k
прывітацца	p r ɨ vʲ i t a t͡sː a
завінаваціцца	z a vʲ i n a v a t͡sʲ i t͡sː a
самаадукацыя	s a m a a d u k a t͡s ɨ j a
парамантаваць	p a r a m a n t a v a t͡sʲ
зрашэціць	z r a ʂ ɛ t͡sʲ i t͡sʲ
перахаваць	pʲ ɛ r a x a v a t͡sʲ
хвіліна	x vʲ i lʲ i n a
астатні	a s t a t nʲ i
кіт	kʲ i t
беспрацоўе	bʲ ɛ s p r a t͡s ɔ w j ɛ
пласкатвары	p ɫ a s k a t v a r ɨ
ракавінка	r a k a vʲ i n k a
паўдзельнічаць	p a w d͡zʲ ɛ lʲ nʲ i t͡ʂ a t͡sʲ
разнітаваць	r a zʲ nʲ i t a v a t͡sʲ
забоўтаць	z a b ɔ w t a t͡sʲ
стромы	s t r ɔ m ɨ
капуснішча	k a p u sʲ nʲ i ʂ t͡ʂ a
сажалка	s a ʐ a ɫ k a
узвалачы	u z v a ɫ a t͡ʂ ɨ
выгаліць	v ɨ ɣ a lʲ i t͡sʲ
вільготны	vʲ i lʲ ɣ ɔ t n ɨ
запытлівы	z a p ɨ t lʲ i v ɨ
заўвага	z a w v a ɣ a
слізкі	sʲ lʲ i z kʲ i
расківаць	r a s kʲ i v a t͡sʲ
зваднік	z v a d nʲ i k
раздабыткі:	r a z d a b ɨ t kʲ i :
хартоўнік	x a r t ɔ w nʲ i k
паскварыць	p a s k v a r ɨ t͡sʲ
раскоўзаць	r a s k ɔ w z a t͡sʲ
пісьменнасць	pʲ i sʲ mʲ ɛ nː a sʲ t͡sʲ
усёахопны	u sʲ ɔ a x ɔ p n ɨ
талака	t a ɫ a k a
адпомсціць	a d p ɔ m sʲ t͡sʲ i t͡sʲ
паадлічваць	p a a d lʲ i t͡ʂ v a t͡sʲ
уяўны	u j a w n ɨ
марудлівы	m a r u d lʲ i v ɨ
хлуслівы	x ɫ u sʲ lʲ i v ɨ
пасвіць	p a sʲ vʲ i t͡sʲ
прытомніць	p r ɨ t ɔ m nʲ i t͡sʲ
разлыгаць	r a z ɫ ɨ ɣ a t͡sʲ
выдзіраць	v ɨ d͡zʲ i r a t͡sʲ
пакратацца	p a k r a t a t͡sː a
клапатлівы	k ɫ a p a t lʲ i v ɨ
пярэпалахі	pʲ a r ɛ p a ɫ a xʲ i
сашмаргнуць	s a ʂ m a r ɣ n u t͡sʲ
абабіць	a b a bʲ i t͡sʲ
порцыя	p ɔ r t͡s ɨ j a
прымурак	p r ɨ m u r a k
трохрадкоўе	t r ɔ x r a d k ɔ w j ɛ
скала	s k a ɫ a
аазіс	a a zʲ i s
разгушкаць	r a z ɣ u ʂ k a t͡sʲ
цурчэць	t͡s u r t͡ʂ ɛ t͡sʲ
перахіліцца	pʲ ɛ r a xʲ i lʲ i t͡sː a
паўаксаміт	p a w a k s a mʲ i t
прыбрукаваць	p r ɨ b r u k a v a t͡sʲ
палац	p a ɫ a t͡s
калаціць	k a ɫ a t͡sʲ i t͡sʲ
дзівасіл	d͡zʲ i v a sʲ i ɫ
доўгі	d ɔ w ɣʲ i
кірунак	kʲ i r u n a k
раўналежны	r a w n a lʲ ɛ ʐ n ɨ
сяліба	sʲ a lʲ i b a
укласці	u k ɫ a sʲ t͡sʲ i
грувасткі	ɣ r u v a s t kʲ i
вянгліна	vʲ a n ɣ lʲ i n a
паснедаць	p a sʲ nʲ ɛ d a t͡sʲ
цапільна	t͡s a pʲ i lʲ n a
зрабіць	z r a bʲ i t͡sʲ
узбудзіць	u z b u d͡zʲ i t͡sʲ
уберагчы	u bʲ ɛ r a ɣ t͡ʂ ɨ
дарадзіць	d a r a d͡zʲ i t͡sʲ
усвядоміць	u sʲ vʲ a d ɔ mʲ i t͡sʲ
бабіна	b a bʲ i n a
светла-чырвоны	sʲ vʲ ɛ t ɫ a - t͡ʂ ɨ r v ɔ n ɨ
ахаладжальнік	a x a ɫ a d ʐ a lʲ nʲ i k
адмільгаць	a d mʲ i lʲ ɣ a t͡sʲ
прасвяткаваць	p r a sʲ vʲ a t k a v a t͡sʲ
самавыключэнне	s a m a v ɨ k lʲ u t͡ʂ ɛ nʲː ɛ
дзічына	d͡zʲ i t͡ʂ ɨ n a
хабарнік	x a b a r nʲ i k
руплівы	r u p lʲ i v ɨ
клубніцы	k ɫ u b nʲ i t͡s ɨ
лік	lʲ i k
неўсталяваны	nʲ ɛ w s t a lʲ a v a n ɨ
прадрукаваць	p r a d r u k a v a t͡sʲ
прагляд	p r a ɣ lʲ a d
смакавы	s m a k a v ɨ
ускраек	u s k r a j ɛ k
зубнік	z u b nʲ i k
закалаціць	z a k a ɫ a t͡sʲ i t͡sʲ
пасмажыць	p a s m a ʐ ɨ t͡sʲ
велізарны	vʲ ɛ lʲ i z a r n ɨ
зёлкі	zʲ ɔ ɫ kʲ i
наадкалупліваць	n a a d k a ɫ u p lʲ i v a t͡sʲ
пустэльнік	p u s t ɛ lʲ nʲ i k
навідавоку	n a vʲ i d a v ɔ k u
замаўляць	z a m a w lʲ a t͡sʲ
пакамячыць	p a k a mʲ a t͡ʂ ɨ t͡sʲ
прамаркоціцца	p r a m a r k ɔ t͡sʲ i t͡sː a
укрыўдзіць	u k r ɨ w d͡zʲ i t͡sʲ
спавівач	s p a vʲ i v a t͡ʂ
наабцярэбліваць	n a a b t͡sʲ a r ɛ b lʲ i v a t͡sʲ
адгаманіць	a d ɣ a m a nʲ i t͡sʲ
гнуткі	ɣ n u t kʲ i
баязлівец	b a j a zʲ lʲ i vʲ ɛ t͡s
абаперці	a b a pʲ ɛ r t͡sʲ i
атаясаміць	a t a j a s a mʲ i t͡sʲ
жніво	ʐ nʲ i v ɔ
парабіць	p a r a bʲ i t͡sʲ
кудзеркі	k u d͡zʲ ɛ r kʲ i
адзінка	a d͡zʲ i n k a
дакопкі	d a k ɔ p kʲ i
перадпачатак	pʲ ɛ r a d p a t͡ʂ a t a k
ілгаць	i ɫ ɣ a t͡sʲ
пісарчук	pʲ i s a r t͡ʂ u k
жыццяпіс	ʐ ɨ t͡sʲː a pʲ i s
пудла	p u d ɫ a
прадухіліць	p r a d u xʲ i lʲ i t͡sʲ
перавыканаць	pʲ ɛ r a v ɨ k a n a t͡sʲ
цягнік	t͡sʲ a ɣ nʲ i k
сподак	s p ɔ d a k
ліслівец	lʲ i sʲ lʲ i vʲ ɛ t͡s
самотны	s a m ɔ t n ɨ
партфель	p a r t fʲ ɛ lʲ
пагодлівы	p a ɣ ɔ d lʲ i v ɨ
учадзець	u t͡ʂ a d͡zʲ ɛ t͡sʲ
тып	t ɨ p
пераблытаць	pʲ ɛ r a b ɫ ɨ t a t͡sʲ
прыплюшчыць	p r ɨ p lʲ u ʂ t͡ʂ ɨ t͡sʲ
прыгоства	p r ɨ ɣ ɔ s t v a
прымаразак	p r ɨ m a r a z a k
стаміць	s t a mʲ i t͡sʲ
пацерабіць	p a t͡sʲ ɛ r a bʲ i t͡sʲ
рабацінне	r a b a t͡sʲ i nʲː ɛ
уласцівы	u ɫ a sʲ t͡sʲ i v ɨ
чытач	t͡ʂ ɨ t a t͡ʂ
самазапальнік	s a m a z a p a lʲ nʲ i k
гадзіннік	ɣ a d͡zʲ i nʲː i k
аўсюк	a w sʲ u k
рэпацца	r ɛ p a t͡sː a
мясціць	mʲ a sʲ t͡sʲ i t͡sʲ
караністы	k a r a nʲ i s t ɨ
пакіраваць	p a kʲ i r a v a t͡sʲ
падкрэсліць	p a d k r ɛ sʲ lʲ i t͡sʲ
прапрасаваць	p r a p r a s a v a t͡sʲ
ачарніць	a t͡ʂ a r nʲ i t͡sʲ
ачапіць	a t͡ʂ a pʲ i t͡sʲ
самаўладдзе	s a m a w ɫ a d͡zʲː ɛ
усачыць	u s a t͡ʂ ɨ t͡sʲ
зблізку	z b lʲ i z k u
самаспаленне	s a m a s p a lʲ ɛ nʲː ɛ
распесціць	r a sʲ pʲ ɛ sʲ t͡sʲ i t͡sʲ
прымета	p r ɨ mʲ ɛ t a
саматужны	s a m a t u ʐ n ɨ
рабаўнік	r a b a w nʲ i k
паўгортваць	p a w ɣ ɔ r t v a t͡sʲ
кветнік	k vʲ ɛ t nʲ i k
імшарніца	i m ʂ a r nʲ i t͡s a
саскрэбці	s a s k r ɛ b t͡sʲ i
надакучлівы	n a d a k u t͡ʂ lʲ i v ɨ
ухіл	u xʲ i ɫ
перагушкаць	pʲ ɛ r a ɣ u ʂ k a t͡sʲ
абвінаваўца	a b vʲ i n a v a w t͡s a
хіснуць	xʲ i s n u t͡sʲ
шасцігадзінны	ʂ a sʲ t͡sʲ i ɣ a d͡zʲ i nː ɨ
паўбоцікі	p a w b ɔ t͡sʲ i kʲ i
вазоўня	v a z ɔ w nʲ a
чубіць	t͡ʂ u bʲ i t͡sʲ
адправадзіць	a d p r a v a d͡zʲ i t͡sʲ
пазачыняць	p a z a t͡ʂ ɨ nʲ a t͡sʲ
уцяпляльнік	u t͡sʲ a p lʲ a lʲ nʲ i k
вербніца	vʲ ɛ r b nʲ i t͡s a
суадносіны	s u a d n ɔ sʲ i n ɨ
прыбегчы	p r ɨ bʲ ɛ ɣ t͡ʂ ɨ
правасвядомасць	p r a v a sʲ vʲ a d ɔ m a sʲ t͡sʲ
віж	vʲ i ʐ
знізіць	zʲ nʲ i zʲ i t͡sʲ
бліскуча	b lʲ i s k u t͡ʂ a
сівізна	sʲ i vʲ i z n a
позех	p ɔ zʲ ɛ x
фатыга	f a t ɨ ɣ a
палінеіць	p a lʲ i nʲ ɛ j i t͡sʲ
залік	z a lʲ i k
пяцікантовік	pʲ a t͡sʲ i k a n t ɔ vʲ i k
раўнавага	r a w n a v a ɣ a
цяжкавоз	t͡sʲ a ʐ k a v ɔ z
прыродазнаўства	p r ɨ r ɔ d a z n a w s t v a
паміж	p a mʲ i ʐ
споўніцца	s p ɔ w nʲ i t͡sː a
захіліць	z a xʲ i lʲ i t͡sʲ
падцяпліць	p a d t͡sʲ a p lʲ i t͡sʲ
панавець	p a n a vʲ ɛ t͡sʲ
раскрыжоўваць	r a s k r ɨ ʐ ɔ w v a t͡sʲ
ціхата	t͡sʲ i x a t a
схлусіць	s x ɫ u sʲ i t͡sʲ
смачны	s m a t͡ʂ n ɨ
рахманець	r a x m a nʲ ɛ t͡sʲ
трыванне	t r ɨ v a nʲː ɛ
выслізгаць	v ɨ sʲ lʲ i z ɣ a t͡sʲ
выказнік	v ɨ k a zʲ nʲ i k
перападрыхтоўка	pʲ ɛ r a p a d r ɨ x t ɔ w k a
шрот	ʂ r ɔ t
руды	r u d ɨ
ападкі	a p a d kʲ i
правазнаўца	p r a v a z n a w t͡s a
фурманка	f u r m a n k a
запрасіць	z a p r a sʲ i t͡sʲ
паўцякаць	p a w t͡sʲ a k a t͡sʲ
хібны	xʲ i b n ɨ
дароўны	d a r ɔ w n ɨ
дранік	d r a nʲ i k
закароткі	z a k a r ɔ t kʲ i
балбатлівасць	b a ɫ b a t lʲ i v a sʲ t͡sʲ
пазамінулы	p a z a mʲ i n u ɫ ɨ
надмуроўка	n a d m u r ɔ w k a
дзівачлівы	d͡zʲ i v a t͡ʂ lʲ i v ɨ
шатроўка	ʂ a t r ɔ w k a
асвятліць	a sʲ vʲ a t lʲ i t͡sʲ
выпаліць	v ɨ p a lʲ i t͡sʲ
пал	p a ɫ
даўзброіць	d a w z b r ɔ j i t͡sʲ
безгаспадарлівы	bʲ ɛ z ɣ a s p a d a r lʲ i v ɨ
канюшынішча	k a nʲ u ʂ ɨ nʲ i ʂ t͡ʂ a
прыбытковы	p r ɨ b ɨ t k ɔ v ɨ
шлях	ʂ lʲ a x
уладальнік	u ɫ a d a lʲ nʲ i k
падкалупіць	p a d k a ɫ u pʲ i t͡sʲ
шалік	ʂ a lʲ i k
узвіць	u zʲ vʲ i t͡sʲ
ганьбіць	ɣ a nʲ bʲ i t͡sʲ
ваўкаваты	v a w k a v a t ɨ
сцепануцца	sʲ t͡sʲ ɛ p a n u t͡sː a
таямніца	t a j a m nʲ i t͡s a
прастадушнасць	p r a s t a d u ʂ n a sʲ t͡sʲ
самаабмежаванне	s a m a a b mʲ ɛ ʐ a v a nʲː ɛ
завіхацца	z a vʲ i x a t͡sː a
пераціснуць	pʲ ɛ r a t͡sʲ i s n u t͡sʲ
усхадзіцца	u s x a d͡zʲ i t͡sː a
навэндзіць	n a v ɛ n d͡zʲ i t͡sʲ
папялісты	p a pʲ a lʲ i s t ɨ
уласнік	u ɫ a sʲ nʲ i k
кінаглядач	kʲ i n a ɣ lʲ a d a t͡ʂ
пакорлівы	p a k ɔ r lʲ i v ɨ
заўчора	z a w t͡ʂ ɔ r a
супрацоўнік	s u p r a t͡s ɔ w nʲ i k
кіў	kʲ i w
адраіць	a d r a j i t͡sʲ
садавіна	s a d a vʲ i n a
палатно	p a ɫ a t n ɔ
блізняты	b lʲ i zʲ nʲ a t ɨ
пазбыцца	p a z b ɨ t͡sː a
гусці	ɣ u sʲ t͡sʲ i
прыпыніць	p r ɨ p ɨ nʲ i t͡sʲ
нейкі	nʲ ɛ j kʲ i
патурбаваць	p a t u r b a v a t͡sʲ
глыбіня	ɣ ɫ ɨ bʲ i nʲ a
прапампаваць	p r a p a m p a v a t͡sʲ
недабіткі	nʲ ɛ d a bʲ i t kʲ i
вадзянік	v a d͡zʲ a nʲ i k
эвакашпіталь	ɛ v a k a ʂ pʲ i t a lʲ
пакрэсліць	p a k r ɛ sʲ lʲ i t͡sʲ
аграмадзіць	a ɣ r a m a d͡zʲ i t͡sʲ
безумоўны	bʲ ɛ z u m ɔ w n ɨ
абараніць	a b a r a nʲ i t͡sʲ
істота	i s t ɔ t a
парада	p a r a d a
заціўкаць	z a t͡sʲ i w k a t͡sʲ
гарачлівы	ɣ a r a t͡ʂ lʲ i v ɨ
сваволіць	s v a v ɔ lʲ i t͡sʲ
выправіць	v ɨ p r a vʲ i t͡sʲ
дыбачкі	d ɨ b a t͡ʂ kʲ i
пацясніць	p a t͡sʲ a sʲ nʲ i t͡sʲ
роўнядзь	r ɔ w nʲ a d zʲ
багнішча	b a ɣ nʲ i ʂ t͡ʂ a
пралічыцца	p r a lʲ i t͡ʂ ɨ t͡sː a
вапнаўка	v a p n a w k a
падцерабіць	p a d t͡sʲ ɛ r a bʲ i t͡sʲ
выкідаць	v ɨ kʲ i d a t͡sʲ
убрыкнуць	u b r ɨ k n u t͡sʲ
прамаляваць	p r a m a lʲ a v a t͡sʲ
панасмажваць	p a n a s m a ʐ v a t͡sʲ
глебаўтварэнне	ɣ lʲ ɛ b a w t v a r ɛ nʲː ɛ
учынак	u t͡ʂ ɨ n a k
поўсць	p ɔ w sʲ t͡sʲ
здрадлівы	z d r a d lʲ i v ɨ
гідкі	ɣʲ i d kʲ i
аглядальнік	a ɣ lʲ a d a lʲ nʲ i k
схапіць	s x a pʲ i t͡sʲ
пазацярушваць	p a z a t͡sʲ a r u ʂ v a t͡sʲ
спакуснік	s p a k u sʲ nʲ i k
казачнік	k a z a t͡ʂ nʲ i k
раздзьмухаць	r a z d zʲ m u x a t͡sʲ
усчапіць	u s t͡ʂ a pʲ i t͡sʲ
углядзецца	u ɣ lʲ a d͡zʲ ɛ t͡sː a
панапякаць	p a n a pʲ a k a t͡sʲ
кнігагандаль	k nʲ i ɣ a ɣ a n d a lʲ
шалёўка	ʂ a lʲ ɔ w k a
пагарэзіць	p a ɣ a r ɛ zʲ i t͡sʲ
свідар	sʲ vʲ i d a r
металаапрацоўка	mʲ ɛ t a ɫ a a p r a t͡s ɔ w k a
узычыць	u z ɨ t͡ʂ ɨ t͡sʲ
прарэзлівы	p r a r ɛ zʲ lʲ i v ɨ
абяззброіць	a bʲ a z z b r ɔ j i t͡sʲ
параструшчваць	p a r a s t r u ʂ t͡ʂ v a t͡sʲ
скон	s k ɔ n
сведка	sʲ vʲ ɛ d k a
часта	t͡ʂ a s t a
сцэдкі	s t͡s ɛ d kʲ i
знасіць	z n a sʲ i t͡sʲ
бэсціць	b ɛ sʲ t͡sʲ i t͡sʲ
паўшоры	p a w ʂ ɔ r ɨ
хмыз	x m ɨ z
плямісты	p lʲ a mʲ i s t ɨ
сяміразовы	sʲ a mʲ i r a z ɔ v ɨ
свідравіна	sʲ vʲ i d r a vʲ i n a
бязладзіца	bʲ a z ɫ a d͡zʲ i t͡s a
крыўда	k r ɨ w d a
мастацтвазнаўства	m a s t a t͡s t v a z n a w s t v a
разгубіць	r a z ɣ u bʲ i t͡sʲ
узброіць	u z b r ɔ j i t͡sʲ
іншадумец	i n ʂ a d u mʲ ɛ t͡s
уцяжарыць	u t͡sʲ a ʐ a r ɨ t͡sʲ
велічэзны	vʲ ɛ lʲ i t͡ʂ ɛ z n ɨ
паперакульваць	p a pʲ ɛ r a k u lʲ v a t͡sʲ
наведвальнік	n a vʲ ɛ d v a lʲ nʲ i k
узаемазалежнасць	u z a j ɛ m a z a lʲ ɛ ʐ n a sʲ t͡sʲ
упаўнаважыць	u p a w n a v a ʐ ɨ t͡sʲ
замянціць	z a mʲ a n t͡sʲ i t͡sʲ
шкодзіць	ʂ k ɔ d͡zʲ i t͡sʲ
самаўзбраенне	s a m a w z b r a j ɛ nʲː ɛ
прымацаваць	p r ɨ m a t͡s a v a t͡sʲ
памерлы	p a mʲ ɛ r ɫ ɨ
праймацца	p r a j m a t͡sː a
кіназдымка	kʲ i n a z d ɨ m k a
падцэліць	p a d t͡s ɛ lʲ i t͡sʲ
круціць	k r u t͡sʲ i t͡sʲ
трохлітарны	t r ɔ x lʲ i t a r n ɨ
самотнік	s a m ɔ t nʲ i k
цывільны	t͡s ɨ vʲ i lʲ n ɨ
далікатны	d a lʲ i k a t n ɨ
прыпалохаць	p r ɨ p a ɫ ɔ x a t͡sʲ
зараснік	z a r a sʲ nʲ i k
першадрукар	pʲ ɛ r ʂ a d r u k a r
абцугі	a b t͡s u ɣʲ i
забліскаць	z a b lʲ i s k a t͡sʲ
сумножнік	s u m n ɔ ʐ nʲ i k
дзесяціразовы	d͡zʲ ɛ sʲ a t͡sʲ i r a z ɔ v ɨ
угарэцца	u ɣ a r ɛ t͡sː a
разбурыць	r a z b u r ɨ t͡sʲ
дасніць	d a sʲ nʲ i t͡sʲ
па-чартоўску	p a - t͡ʂ a r t ɔ w s k u
зашкодзіць	z a ʂ k ɔ d͡zʲ i t͡sʲ
страла	s t r a ɫ a
мсцівы	m sʲ t͡sʲ i v ɨ
спесціць	sʲ pʲ ɛ sʲ t͡sʲ i t͡sʲ
пахіл	p a xʲ i ɫ
бліскаць	b lʲ i s k a t͡sʲ
план	p ɫ a n
сцурацца	s t͡s u r a t͡sː a
высіліцца	v ɨ sʲ i lʲ i t͡sː a
знаўца	z n a w t͡s a
прылітоўка	p r ɨ lʲ i t ɔ w k a
павысвідроўваць	p a v ɨ sʲ vʲ i d r ɔ w v a t͡sʲ
ціск	t͡sʲ i s k
грабежнік	ɣ r a bʲ ɛ ʐ nʲ i k
пашанцаваць	p a ʂ a n t͡s a v a t͡sʲ
наўрад	n a w r a d
найцікавейшы	n a j t͡sʲ i k a vʲ ɛ j ʂ ɨ
занізка	z a nʲ i z k a
абнімкі	a b nʲ i m kʲ i
сваяўство	s v a j a w s t v ɔ
рагатун	r a ɣ a t u n
здзіўленне	z d͡zʲ i w lʲ ɛ nʲː ɛ
ахвотнік	a x v ɔ t nʲ i k
штурхель	ʂ t u r x j ɛ lʲ
азнаёміць	a z n a j ɔ mʲ i t͡sʲ
канаплішча	k a n a p lʲ i ʂ t͡ʂ a
зімны	zʲ i m n ɨ
уніклівы	u nʲ i k lʲ i v ɨ
худзізна	x u d͡zʲ i z n a
разлеглы	r a zʲ lʲ ɛ ɣ ɫ ɨ
рэчывізм	r ɛ t͡ʂ ɨ vʲ i z m
падстрэшнік	p a d s t r ɛ ʂ nʲ i k
круціцца	k r u t͡sʲ i t͡sː a
панасіцца	p a n a sʲ i t͡sː a
прычыніць	p r ɨ t͡ʂ ɨ nʲ i t͡sʲ
увасабляць	u v a s a b lʲ a t͡sʲ
пхнуць	p x n u t͡sʲ
прамарнаваць	p r a m a r n a v a t͡sʲ
абвінуць	a b vʲ i n u t͡sʲ
хрэсьбіны	x r ɛ sʲ bʲ i n ɨ
шампанскае	ʂ a m p a n s k a j ɛ
знакаміты	z n a k a mʲ i t ɨ
пашлындаць	p a ʂ ɫ ɨ n d a t͡sʲ
сурвэтка	s u r v ɛ t k a
пераспяваць	pʲ ɛ r a sʲ pʲ a v a t͡sʲ
падкалаціць	p a d k a ɫ a t͡sʲ i t͡sʲ
шукаць	ʂ u k a t͡sʲ
пахарчаваць	p a x a r t͡ʂ a v a t͡sʲ
кідальнік	kʲ i d a lʲ nʲ i k
мастацтвазнаўца	m a s t a t͡s t v a z n a w t͡s a
сёрбаць	sʲ ɔ r b a t͡sʲ
цень	t͡sʲ ɛ nʲ
прыгнятальнік	p r ɨ ɣ nʲ a t a lʲ nʲ i k
выявіць	v ɨ j a vʲ i t͡sʲ
злічыць	zʲ lʲ i t͡ʂ ɨ t͡sʲ
падціснуць	p a d t͡sʲ i s n u t͡sʲ
ушчуванне	u ʂ t͡ʂ u v a nʲː ɛ
вірысты	vʲ i r ɨ s t ɨ
шэры	ʂ ɛ r ɨ
узнавіць	u z n a vʲ i t͡sʲ
грабільна	ɣ r a bʲ i lʲ n a
плеўка	p lʲ ɛ w k a
сягоння	sʲ a ɣ ɔ nʲː a
прыпознены	p r ɨ p ɔ zʲ nʲ ɛ n ɨ
расіцца	r a sʲ i t͡sː a
сумяшчальнасць	s u mʲ a ʂ t͡ʂ a lʲ n a sʲ t͡sʲ
складанасць	s k ɫ a d a n a sʲ t͡sʲ
прысарамаціць	p r ɨ s a r a m a t͡sʲ i t͡sʲ
адпаліць	a d p a lʲ i t͡sʲ
напаўвадкі	n a p a w v a d kʲ i
зноў	z n ɔ w
крэсліць	k r ɛ sʲ lʲ i t͡sʲ
спеўнік	sʲ pʲ ɛ w nʲ i k
пацішэць	p a t͡sʲ i ʂ ɛ t͡sʲ
напрадвесні	n a p r a d vʲ ɛ sʲ nʲ i
ультрагук	u lʲ t r a ɣ u k
клейкі	k lʲ ɛ j kʲ i
памысны	p a m ɨ s n ɨ
прычакаць	p r ɨ t͡ʂ a k a t͡sʲ
паўтузіна	p a w t u zʲ i n a
жывапіс	ʐ ɨ v a pʲ i s
забудоўшчык	z a b u d ɔ w ʂ t͡ʂ ɨ k
прыцьміць	p r ɨ t͡sʲ mʲ i t͡sʲ
мліва	m lʲ i v a
сужыццё	s u ʐ ɨ t͡sʲː ɔ
прашмараваць	p r a ʂ m a r a v a t͡sʲ
растаўчы	r a s t a w t͡ʂ ɨ
згразіць	z ɣ r a zʲ i t͡sʲ
грузаёмістасць	ɣ r u z a j ɔ mʲ i s t a sʲ t͡sʲ
абкідаць	a b kʲ i d a t͡sʲ
слізгануць	sʲ lʲ i z ɣ a n u t͡sʲ
палічыць	p a lʲ i t͡ʂ ɨ t͡sʲ
палашчыць	p a ɫ a ʂ t͡ʂ ɨ t͡sʲ
скрэбла	s k r ɛ b ɫ a
віскатлівы	vʲ i s k a t lʲ i v ɨ
карыстальнік	k a r ɨ s t a lʲ nʲ i k
драбніца	d r a b nʲ i t͡s a
закрэсліць	z a k r ɛ sʲ lʲ i t͡sʲ
выкідальнік	v ɨ kʲ i d a lʲ nʲ i k
асаблівы	a s a b lʲ i v ɨ
рамеснік	r a mʲ ɛ sʲ nʲ i k
пакараць	p a k a r a t͡sʲ
узбройваць	u z b r ɔ j v a t͡sʲ
размроіцца	r a z m r ɔ j i t͡sː a
пярэсціна	pʲ a r ɛ sʲ t͡sʲ i n a
несамавіты	nʲ ɛ s a m a vʲ i t ɨ
высокапрадуктыўны	v ɨ s ɔ k a p r a d u k t ɨ w n ɨ
расхлістаць	r a s x lʲ i s t a t͡sʲ
супервокладка	s u pʲ ɛ r v ɔ k ɫ a d k a
разбэсціцца	r a z b ɛ sʲ t͡sʲ i t͡sː a
памалу	p a m a ɫ u
ранішнік	r a nʲ i ʂ nʲ i k
цырульня	t͡s ɨ r u lʲ nʲ a
рэхва	r ɛ x v a
трохі	t r ɔ xʲ i
лапіць	ɫ a pʲ i t͡sʲ
паўтлусты	p a w t ɫ u s t ɨ
прыгаршчы	p r ɨ ɣ a r ʂ t͡ʂ ɨ
сумяшчальны	s u mʲ a ʂ t͡ʂ a lʲ n ɨ
страляніна	s t r a lʲ a nʲ i n a
шарон	ʂ a r ɔ n
адгладзіць	a d ɣ ɫ a d͡zʲ i t͡sʲ
ажыннік	a ʐ ɨ nʲː i k
скоўзаць	s k ɔ w z a t͡sʲ
папрыгажэць	p a p r ɨ ɣ a ʐ ɛ t͡sʲ
надаўжэй	n a d a w ʐ ɛ j
увільгатніць	u vʲ i lʲ ɣ a t nʲ i t͡sʲ
пералупцаваць	pʲ ɛ r a ɫ u p t͡s a v a t͡sʲ
разводдзе	r a z v ɔ d͡zʲː ɛ
важкі	v a ʐ kʲ i
цвяліць	t͡sʲ vʲ a lʲ i t͡sʲ
мінулы	mʲ i n u ɫ ɨ
чапяльнік	t͡ʂ a pʲ a lʲ nʲ i k
паўрасплюшчаны	p a w r a s p lʲ u ʂ t͡ʂ a n ɨ
суравізна	s u r a vʲ i z n a
кіпцюрасты	kʲ i p t͡sʲ u r a s t ɨ
пазабаўляць	p a z a b a w lʲ a t͡sʲ
прагарына	p r a ɣ a r ɨ n a
ускладніць	u s k ɫ a d nʲ i t͡sʲ
хутчэй	x u t͡ʂː ɛ j
краўчыха	k r a w t͡ʂ ɨ x a
цвікля	t͡sʲ vʲ i k lʲ a
упершыню	u pʲ ɛ r ʂ ɨ nʲ u
шкло	ʂ k ɫ ɔ
прылаўчыцца	p r ɨ ɫ a w t͡ʂ ɨ t͡sː a
цурок	t͡s u r ɔ k
зацішны	z a t͡sʲ i ʂ n ɨ
пашкодзіць	p a ʂ k ɔ d͡zʲ i t͡sʲ
запярэсціцца	z a pʲ a r ɛ sʲ t͡sʲ i t͡sː a
кіпень	kʲ i pʲ ɛ nʲ
рудаўка	r u d a w k a
касцяніца	k a sʲ t͡sʲ a nʲ i t͡s a
распудзіць	r a s p u d͡zʲ i t͡sʲ
паатрымліваць	p a a t r ɨ m lʲ i v a t͡sʲ
застраміць	z a s t r a mʲ i t͡sʲ
льноапрацоўка	lʲ n ɔ a p r a t͡s ɔ w k a
уступаць	u s t u p a t͡sʲ
павеў	p a vʲ ɛ w
шкода	ʂ k ɔ d a
расскубці	r a s s k u b t͡sʲ i
радыёслухач	r a d ɨ j ɔ s ɫ u x a t͡ʂ
зрыўкі	z r ɨ w kʲ i
бульбянішча	b u lʲ bʲ a nʲ i ʂ t͡ʂ a
скарыстаць	s k a r ɨ s t a t͡sʲ
прадпрыемніцтва	p r a d p r ɨ j ɛ m nʲ i t͡s t v a
старадаўні	s t a r a d a w nʲ i
захліпнуцца	z a x lʲ i p n u t͡sː a
удзячнасць	u d͡zʲ a t͡ʂ n a sʲ t͡sʲ
завільгатнець	z a vʲ i lʲ ɣ a t nʲ ɛ t͡sʲ
пацеркі	p a t͡sʲ ɛ r kʲ i
самазабойца	s a m a z a b ɔ j t͡s a
конік	k ɔ nʲ i k
замінаць	z a mʲ i n a t͡sʲ
словаўтварэнне	s ɫ ɔ v a w t v a r ɛ nʲː ɛ
гвалтоўны	ɣ v a ɫ t ɔ w n ɨ
патынкаваць	p a t ɨ n k a v a t͡sʲ
перадзяўбці	pʲ ɛ r a d͡zʲ a w b t͡sʲ i
яр	j a r
сунімаць	s u nʲ i m a t͡sʲ
аджгір	a d ʐ ɣʲ i r
утрываць	u t r ɨ v a t͡sʲ
развага	r a z v a ɣ a
ліхадзейнічаць	lʲ i x a d͡zʲ ɛ j nʲ i t͡ʂ a t͡sʲ
невымоўны	nʲ ɛ v ɨ m ɔ w n ɨ
прагарнуць	p r a ɣ a r n u t͡sʲ
старэчы	s t a r ɛ t͡ʂ ɨ
падкоўдранік	p a d k ɔ w d r a nʲ i k
палунаць	p a ɫ u n a t͡sʲ
цягавіты	t͡sʲ a ɣ a vʲ i t ɨ
бакавіна	b a k a vʲ i n a
светабудова	sʲ vʲ ɛ t a b u d ɔ v a
хатні	x a t nʲ i
пяціскладовы	pʲ a t͡sʲ i s k ɫ a d ɔ v ɨ
папіхаць	p a pʲ i x a t͡sʲ
ключыкі	k lʲ u t͡ʂ ɨ kʲ i
паркан	p a r k a n
лішак	lʲ i ʂ a k
абдзяўбці	a b d͡zʲ a w b t͡sʲ i
абсівераць	a b sʲ i vʲ ɛ r a t͡sʲ
юр	j u r
узбіць	u zʲ bʲ i t͡sʲ
знішчыць	zʲ nʲ i ʂ t͡ʂ ɨ t͡sʲ
забараніць	z a b a r a nʲ i t͡sʲ
відэлец	vʲ i d ɛ lʲ ɛ t͡s
вярзці	vʲ a r zʲ t͡sʲ i
сканаць	s k a n a t͡sʲ
перадаручыць	pʲ ɛ r a d a r u t͡ʂ ɨ t͡sʲ
пераскубці	pʲ ɛ r a s k u b t͡sʲ i
заглыбіць	z a ɣ ɫ ɨ bʲ i t͡sʲ
паадцінаць	p a a d t͡sʲ i n a t͡sʲ
замілавальны	z a mʲ i ɫ a v a lʲ n ɨ
рассек	r a sʲː ɛ k
развярэдзіць	r a zʲ vʲ a r ɛ d͡zʲ i t͡sʲ
пазнаёміць	p a z n a j ɔ mʲ i t͡sʲ
скудлаціць	s k u d ɫ a t͡sʲ i t͡sʲ
дабратлівы	d a b r a t lʲ i v ɨ
засаладзіць	z a s a ɫ a d͡zʲ i t͡sʲ
безвыніковасць	bʲ ɛ z v ɨ nʲ i k ɔ v a sʲ t͡sʲ
заканадаўца	z a k a n a d a w t͡s a
перасварыць	pʲ ɛ r a s v a r ɨ t͡sʲ
ушчыльніць	u ʂ t͡ʂ ɨ lʲ nʲ i t͡sʲ
узлесак	u zʲ lʲ ɛ s a k
аблямоўка	a b lʲ a m ɔ w k a
вылік	v ɨ lʲ i k
падручнік	p a d r u t͡ʂ nʲ i k
знячэўку	zʲ nʲ a t͡ʂ ɛ w k u
прапрацаваць	p r a p r a t͡s a v a t͡sʲ
адкрэсліць	a d k r ɛ sʲ lʲ i t͡sʲ
пільнаваць	pʲ i lʲ n a v a t͡sʲ
сокал	s ɔ k a ɫ
перагрупаваць	pʲ ɛ r a ɣ r u p a v a t͡sʲ
пакаштаваць	p a k a ʂ t a v a t͡sʲ
каціны	k a t͡sʲ i n ɨ
вільготнасць	vʲ i lʲ ɣ ɔ t n a sʲ t͡sʲ
прасмажыць	p r a s m a ʐ ɨ t͡sʲ
уторкнуць	u t ɔ r k n u t͡sʲ
дзірванець	d͡zʲ i r v a nʲ ɛ t͡sʲ
паляўнічы	p a lʲ a w nʲ i t͡ʂ ɨ
збіраць	zʲ bʲ i r a t͡sʲ
агністы	a ɣ nʲ i s t ɨ
абкітоўка	a b kʲ i t ɔ w k a
аднасхільны	a d n a s xʲ i lʲ n ɨ
настаўнік	n a s t a w nʲ i k
паляўніцтвазнаўства	p a lʲ a w nʲ i t͡s t v a z n a w s t v a
адмовіцца	a d m ɔ vʲ i t͡sː a
вызначальнік	v ɨ z n a t͡ʂ a lʲ nʲ i k
счырванець	s t͡ʂ ɨ r v a nʲ ɛ t͡sʲ
прадонне	p r a d ɔ nʲː ɛ
марнатраўства	m a r n a t r a w s t v a
віхура	vʲ i x u r a
сардэчнік	s a r d ɛ t͡ʂ nʲ i k
шафа	ʂ a f a
пераворка	pʲ ɛ r a v ɔ r k a
рахункавод	r a x u n k a v ɔ d
загаіць	z a ɣ a j i t͡sʲ
пралінеіць	p r a lʲ i nʲ ɛ j i t͡sʲ
сшараваць	s ʂ a r a v a t͡sʲ
уведаць	u vʲ ɛ d a t͡sʲ
схмурнець	s x m u r nʲ ɛ t͡sʲ
прыцікаваць	p r ɨ t͡sʲ i k a v a t͡sʲ
перацягаць	pʲ ɛ r a t͡sʲ a ɣ a t͡sʲ
пакпіць	p a k pʲ i t͡sʲ
маладзік	m a ɫ a d͡zʲ i k
абудзіць	a b u d͡zʲ i t͡sʲ
унаравіць	u n a r a vʲ i t͡sʲ
дамалёўка	d a m a lʲ ɔ w k a
спалохаць	s p a ɫ ɔ x a t͡sʲ
ліслівіць	lʲ i sʲ lʲ i vʲ i t͡sʲ
тычка	t ɨ t͡ʂ k a
пацвісці	p a t͡sʲ vʲ i sʲ t͡sʲ i
чэмер	t͡ʂ ɛ mʲ ɛ r
падрабніць	p a d r a b nʲ i t͡sʲ
прабачыць	p r a b a t͡ʂ ɨ t͡sʲ
легкатраўны	lʲ ɛ ɣ k a t r a w n ɨ
грунтоўны	ɣ r u n t ɔ w n ɨ
прабліскаць	p r a b lʲ i s k a t͡sʲ
дзённік	d͡zʲ ɔ nʲː i k
пячонік	pʲ a t͡ʂ ɔ nʲ i k
устрыманасць	u s t r ɨ m a n a sʲ t͡sʲ
спярша	sʲ pʲ a r ʂ a
здоўжыцца	z d ɔ w ʐ ɨ t͡sː a
прывідны	p r ɨ vʲ i d n ɨ
гладзіць	ɣ ɫ a d͡zʲ i t͡sʲ
мікрасвет	mʲ i k r a sʲ vʲ ɛ t
дагарадзіць	d a ɣ a r a d͡zʲ i t͡sʲ
цаглёўка	t͡s a ɣ lʲ ɔ w k a
папільнаваць	p a pʲ i lʲ n a v a t͡sʲ
прыбудаваць	p r ɨ b u d a v a t͡sʲ
пераноссе	pʲ ɛ r a n ɔ sʲː ɛ
свянціць	sʲ vʲ a n t͡sʲ i t͡sʲ
прыгонніцтва	p r ɨ ɣ ɔ nʲː i t͡s t v a
выхаладзіць	v ɨ x a ɫ a d͡zʲ i t͡sʲ
прыполак	p r ɨ p ɔ ɫ a k
страваванне	s t r a v a v a nʲː ɛ
француз	f r a n t͡s u z
пастоптваць	p a s t ɔ p t v a t͡sʲ
прымхлівы	p r ɨ m x lʲ i v ɨ
расцерушыць	r a sʲ t͡sʲ ɛ r u ʂ ɨ t͡sʲ
заладзіць	z a ɫ a d͡zʲ i t͡sʲ
чытанка	t͡ʂ ɨ t a n k a
міжаконне	mʲ i ʐ a k ɔ nʲː ɛ
напаліць	n a p a lʲ i t͡sʲ
хадайнічаць	x a d a j nʲ i t͡ʂ a t͡sʲ
забаўлівы	z a b a w lʲ i v ɨ
узірацца	u zʲ i r a t͡sː a
міжкасцявы	mʲ i ʐ k a sʲ t͡sʲ a v ɨ
з’яўленне	z j a w lʲ ɛ nʲː ɛ
нагавіцы	n a ɣ a vʲ i t͡s ɨ
паўхмызняк	p a w x m ɨ zʲ nʲ a k
ківаць	kʲ i v a t͡sʲ
глебазнаўца	ɣ lʲ ɛ b a z n a w t͡s a
станавіты	s t a n a vʲ i t ɨ
зацвяліць	z a t͡sʲ vʲ a lʲ i t͡sʲ
атрымальнік	a t r ɨ m a lʲ nʲ i k
папляскаць	p a p lʲ a s k a t͡sʲ
сейбіт	sʲ ɛ j bʲ i t
акрэсліць	a k r ɛ sʲ lʲ i t͡sʲ
выкрутлівы	v ɨ k r u t lʲ i v ɨ
высоўны	v ɨ s ɔ w n ɨ
старасветчына	s t a r a sʲ vʲ ɛ t͡ʂː ɨ n a
слоўнік	s ɫ ɔ w nʲ i k
пракрэсліць	p r a k r ɛ sʲ lʲ i t͡sʲ
уздым	u z d ɨ m
прычына	p r ɨ t͡ʂ ɨ n a
бязлесіца	bʲ a zʲ lʲ ɛ sʲ i t͡s a
паўпісьменны	p a w pʲ i sʲ mʲ ɛ nː ɨ
зеўраць	zʲ ɛ w r a t͡sʲ
чуллівы	t͡ʂ u lʲ lʲ ʲ i v ɨ
памізарнець	p a mʲ i z a r nʲ ɛ t͡sʲ
запакоўка	z a p a k ɔ w k a
укеміць	u kʲ ɛ mʲ i t͡sʲ
прыпадабняць	p r ɨ p a d a b nʲ a t͡sʲ
ахвярадаўца	a x vʲ a r a d a w t͡s a
паддзяўбці	p a d͡zʲː a w b t͡sʲ i
фотапапера	f ɔ t a p a pʲ ɛ r a
лістапад	lʲ i s t a p a d
калаціцца	k a ɫ a t͡sʲ i t͡sː a
чароўны	t͡ʂ a r ɔ w n ɨ
нашкліць	n a ʂ k lʲ i t͡sʲ
памаляваць	p a m a lʲ a v a t͡sʲ
шлюб	ʂ lʲ u b
літаратуразнаўства	lʲ i t a r a t u r a z n a w s t v a
закіпяціць	z a kʲ i pʲ a t͡sʲ i t͡sʲ
лічыльнік	lʲ i t͡ʂ ɨ lʲ nʲ i k
аблічча	a b lʲ i t͡ʂː a
сяло	sʲ a ɫ ɔ
слон	s ɫ ɔ n
захрапці	z a x r a p t͡sʲ i
імшанік	i m ʂ a nʲ i k
сава	s a v a
сподні	s p ɔ d nʲ i
штучны	ʂ t u t͡ʂ n ɨ
увярэднік	u vʲ a r ɛ d nʲ i k
вітка	vʲ i t k a
папудзіць	p a p u d͡zʲ i t͡sʲ
сочка	s ɔ t͡ʂ k a
прыцішыць	p r ɨ t͡sʲ i ʂ ɨ t͡sʲ
выслоўе	v ɨ s ɫ ɔ w j ɛ
разважны	r a z v a ʐ n ɨ
праскубці	p r a s k u b t͡sʲ i
упачатку	u p a t͡ʂ a t k u
хісткі	xʲ i s t kʲ i
усёдараванне	u sʲ ɔ d a r a v a nʲː ɛ
цыркаць	t͡s ɨ r k a t͡sʲ
двурожнік	d v u r ɔ ʐ nʲ i k
хлевішча	x lʲ ɛ vʲ i ʂ t͡ʂ a
падкітоўка	p a d kʲ i t ɔ w k a
навыперадкі	n a v ɨ pʲ ɛ r a d kʲ i
асавік	a s a vʲ i k
адцінаць	a d t͡sʲ i n a t͡sʲ
знаёміць	z n a j ɔ mʲ i t͡sʲ
раздзяўбці	r a z d͡zʲ a w b t͡sʲ i
ссініць	sʲː i nʲ i t͡sʲ
іншаземец	i n ʂ a zʲ ɛ mʲ ɛ t͡s
усперціся	u sʲ pʲ ɛ r t͡sʲ i sʲ a
цела	t͡sʲ ɛ ɫ a
паказальны	p a k a z a lʲ n ɨ
мачулішча	m a t͡ʂ u lʲ i ʂ t͡ʂ a
упраўны	u p r a w n ɨ
распасцерці	r a s p a sʲ t͡sʲ ɛ r t͡sʲ i
перавабіць	pʲ ɛ r a v a bʲ i t͡sʲ
успамянуць	u s p a mʲ a n u t͡sʲ
высвенціць	v ɨ sʲ vʲ ɛ n t͡sʲ i t͡sʲ
учапіць	u t͡ʂ a pʲ i t͡sʲ
баваўнаводства	b a v a w n a v ɔ d s t v a
падлямоўка	p a d lʲ a m ɔ w k a
скрасці	s k r a sʲ t͡sʲ i
апыляльнік	a p ɨ lʲ a lʲ nʲ i k
ціўкаць	t͡sʲ i w k a t͡sʲ
чашчавік	t͡ʂ a ʂ t͡ʂ a vʲ i k
жалобніца	ʐ a ɫ ɔ b nʲ i t͡s a
панатапырваць	p a n a t a p ɨ r v a t͡sʲ
повідну	p ɔ vʲ i d n u
здаўна	z d a w n a
зрэбнікі	z r ɛ b nʲ i kʲ i
ватоўка	v a t ɔ w k a
упарадкаваць	u p a r a d k a v a t͡sʲ
сачэнне	s a t͡ʂ ɛ nʲː ɛ
журлівы	ʐ u r lʲ i v ɨ
усялякі	u sʲ a lʲ a kʲ i
правамоцтва	p r a v a m ɔ t͡s t v a
ускосны	u s k ɔ s n ɨ
прыспяшыць	p r ɨ sʲ pʲ a ʂ ɨ t͡sʲ
ахоўны	a x ɔ w n ɨ
уважлівы	u v a ʐ lʲ i v ɨ
завалтузіцца	z a v a ɫ t u zʲ i t͡sː a
прысланіць	p r ɨ s ɫ a nʲ i t͡sʲ
дарубіць	d a r u bʲ i t͡sʲ
прыгаіць	p r ɨ ɣ a j i t͡sʲ
сароміць	s a r ɔ mʲ i t͡sʲ
выдаліць	v ɨ d a lʲ i t͡sʲ
зацішша	z a t͡sʲ i ʂ ʂ a
творчы	t v ɔ r t͡ʂ ɨ
шаша	ʂ a ʂ a
парассоўваць	p a r a s s ɔ w v a t͡sʲ
змусіць	z m u sʲ i t͡sʲ
азірнуцца	a zʲ i r n u t͡sː a
усеўладства	u sʲ ɛ w ɫ a d s t v a
квашаніна	k v a ʂ a nʲ i n a
скорамінучы	s k ɔ r a mʲ i n u t͡ʂ ɨ
назоўны	n a z ɔ w n ɨ
множнік	m n ɔ ʐ nʲ i k
пазмагацца	p a z m a ɣ a t͡sː a
развідняцца	r a zʲ vʲ i d nʲ a t͡sː a
змястоўнасць	zʲ mʲ a s t ɔ w n a sʲ t͡sʲ
драбніць	d r a b nʲ i t͡sʲ
хвацкі	x v a t͡s kʲ i
вінаваты	vʲ i n a v a t ɨ
панаракаць	p a n a r a k a t͡sʲ
кепскі	kʲ ɛ p s kʲ i
ужытак	u ʐ ɨ t a k
раніца	r a nʲ i t͡s a
засароміць	z a s a r ɔ mʲ i t͡sʲ
абіўка	a bʲ i w k a
паўкопваць	p a w k ɔ p v a t͡sʲ
папамаляваць	p a p a m a lʲ a v a t͡sʲ
фотаздымак	f ɔ t a z d ɨ m a k
узмацніць	u z m a t͡sʲ nʲ i t͡sʲ
упампаваць	u p a m p a v a t͡sʲ
утойваць	u t ɔ j v a t͡sʲ
папырскаць	p a p ɨ r s k a t͡sʲ
завабіць	z a v a bʲ i t͡sʲ
рэцэпт	r ɛ t͡s ɛ p t
дамоў	d a m ɔ w
заўважыць	z a w v a ʐ ɨ t͡sʲ
цікавіцца	t͡sʲ i k a vʲ i t͡sː a
прыдабыць	p r ɨ d a b ɨ t͡sʲ
замаркоціць	z a m a r k ɔ t͡sʲ i t͡sʲ
прызнацца	p r ɨ z n a t͡sː a
даскрэбці	d a s k r ɛ b t͡sʲ i
круцігалоўка	k r u t͡sʲ i ɣ a ɫ ɔ w k a
устойлівасць	u s t ɔ j lʲ i v a sʲ t͡sʲ
зычлівы	z ɨ t͡ʂ lʲ i v ɨ
заінець	z a j i nʲ ɛ t͡sʲ
спахапіцца	s p a x a pʲ i t͡sː a
развіднець	r a zʲ vʲ i d nʲ ɛ t͡sʲ
габлёўка	ɣ a b lʲ ɔ w k a
паднаціснуць	p a d n a t͡sʲ i s n u t͡sʲ
дагадзіць	d a ɣ a d͡zʲ i t͡sʲ
прывід	p r ɨ vʲ i d
рэчы	r ɛ t͡ʂ ɨ
сучка	s u t͡ʂ k a
смаліць	s m a lʲ i t͡sʲ
павітаць	p a vʲ i t a t͡sʲ
навыбіваць	n a v ɨ bʲ i v a t͡sʲ
радзець	r a d͡zʲ ɛ t͡sʲ
прысвяціць	p r ɨ sʲ vʲ a t͡sʲ i t͡sʲ
угнаіць	u ɣ n a j i t͡sʲ
леснікоўства	lʲ ɛ sʲ nʲ i k ɔ w s t v a
вымаўленчы	v ɨ m a w lʲ ɛ n t͡ʂ ɨ
летазлічэнне	lʲ ɛ t a zʲ lʲ i t͡ʂ ɛ nʲː ɛ
узлессе	u zʲ lʲ ɛ sʲː ɛ
закруціць	z a k r u t͡sʲ i t͡sʲ
малаўжывальны	m a ɫ a w ʐ ɨ v a lʲ n ɨ
здзірванець	z d͡zʲ i r v a nʲ ɛ t͡sʲ
адгін	a d ɣʲ i n
прыбываць	p r ɨ b ɨ v a t͡sʲ
ускласці	u s k ɫ a sʲ t͡sʲ i
хлюпота	x lʲ u p ɔ t a
парасоністы	p a r a s ɔ nʲ i s t ɨ
прарадзіма	p r a r a d͡zʲ i m a
святататнік	sʲ vʲ a t a t a t nʲ i k
прарок	p r a r ɔ k
панаксаміт	p a n a k s a mʲ i t
водаўстойлівы	v ɔ d a w s t ɔ j lʲ i v ɨ
зацікаўленасць	z a t͡sʲ i k a w lʲ ɛ n a sʲ t͡sʲ
мільгаць	mʲ i lʲ ɣ a t͡sʲ
раскалупаць	r a s k a ɫ u p a t͡sʲ
жабнік	ʐ a b nʲ i k
пазначыць	p a z n a t͡ʂ ɨ t͡sʲ
высветліць	v ɨ sʲ vʲ ɛ t lʲ i t͡sʲ
сядзіба	sʲ a d͡zʲ i b a
асабісты	a s a bʲ i s t ɨ
выскрабці	v ɨ s k r a b t͡sʲ i
падлізнік	p a d lʲ i zʲ nʲ i k
загаманіць	z a ɣ a m a nʲ i t͡sʲ
падоўжны	p a d ɔ w ʐ n ɨ
цяпло	t͡sʲ a p ɫ ɔ
мілагучны	mʲ i ɫ a ɣ u t͡ʂ n ɨ
пасходзіцца	p a s x ɔ d͡zʲ i t͡sː a
здзяўбці	z d͡zʲ a w b t͡sʲ i
ацерабіць	a t͡sʲ ɛ r a bʲ i t͡sʲ
працерабіць	p r a t͡sʲ ɛ r a bʲ i t͡sʲ
ліхадумства	lʲ i x a d u m s t v a
даўнейшы	d a w nʲ ɛ j ʂ ɨ
уразіць	u r a zʲ i t͡sʲ
перахвалявацца	pʲ ɛ r a x v a lʲ a v a t͡sː a
аўтамабілебудаўнік	a w t a m a bʲ i lʲ ɛ b u d a w nʲ i k
распластоўка	r a s p ɫ a s t ɔ w k a
галоўны	ɣ a ɫ ɔ w n ɨ
гаманіць	ɣ a m a nʲ i t͡sʲ
кпіць	k pʲ i t͡sʲ
рыбазнаўства	r ɨ b a z n a w s t v a
прыпаліць	p r ɨ p a lʲ i t͡sʲ
праводзіны	p r a v ɔ d͡zʲ i n ɨ
ігліца	i ɣ lʲ i t͡s a
святлапіс	sʲ vʲ a t ɫ a pʲ i s
улагодзіць	u ɫ a ɣ ɔ d͡zʲ i t͡sʲ
адцінак	a d t͡sʲ i n a k
замільгаць	z a mʲ i lʲ ɣ a t͡sʲ
зацінацца	z a t͡sʲ i n a t͡sː a
глінішча	ɣ lʲ i nʲ i ʂ t͡ʂ a
спуд	s p u d
перасцярога	pʲ ɛ r a sʲ t͡sʲ a r ɔ ɣ a
свярдзёлак	sʲ vʲ a r d͡zʲ ɔ ɫ a k
пасябраваць	p a sʲ a b r a v a t͡sʲ
засвідраваць	z a sʲ vʲ i d r a v a t͡sʲ
сталюга	s t a lʲ u ɣ a
папрыточваць	p a p r ɨ t ɔ t͡ʂ v a t͡sʲ
дураслівы	d u r a sʲ lʲ i v ɨ
кукішкі	k u kʲ i ʂ kʲ i
павыратоўваць	p a v ɨ r a t ɔ w v a t͡sʲ
пяцідзёнка	pʲ a t͡sʲ i d͡zʲ ɔ n k a
каробачнік	k a r ɔ b a t͡ʂ nʲ i k
недапрацоўка	nʲ ɛ d a p r a t͡s ɔ w k a
учарнець	u t͡ʂ a r nʲ ɛ t͡sʲ
распуста	r a s p u s t a
плячо	p lʲ a t͡ʂ ɔ
завіліна	z a vʲ i lʲ i n a
сцэна	s t͡s ɛ n a
разумнець	r a z u m nʲ ɛ t͡sʲ
пераўшчыльніць	pʲ ɛ r a w ʂ t͡ʂ ɨ lʲ nʲ i t͡sʲ
пацалаваць	p a t͡s a ɫ a v a t͡sʲ
сугучны	s u ɣ u t͡ʂ n ɨ
пасвідраваць	p a sʲ vʲ i d r a v a t͡sʲ
пітво	pʲ i t v ɔ
зацвілы	z a t͡sʲ vʲ i ɫ ɨ
капуснік	k a p u sʲ nʲ i k
завознік	z a v ɔ zʲ nʲ i k
занатоўка	z a n a t ɔ w k a
насоўка	n a s ɔ w k a
чытэльны	t͡ʂ ɨ t ɛ lʲ n ɨ
надысці	n a d ɨ sʲ t͡sʲ i
покрыўка	p ɔ k r ɨ w k a
адчыніць	a t͡ʂː ɨ nʲ i t͡sʲ
вазніца	v a zʲ nʲ i t͡s a
вірлівы	vʲ i r lʲ i v ɨ
вітушка	vʲ i t u ʂ k a
пруткі	p r u t kʲ i
навіна	n a vʲ i n a
удумлівы	u d u m lʲ i v ɨ
стул	s t u ɫ
пазабрукоўваць	p a z a b r u k ɔ w v a t͡sʲ
таптаць	t a p t a t͡sʲ
пападкасваць	p a p a d k a s v a t͡sʲ
траістасць	t r a j i s t a sʲ t͡sʲ
першагатунковы	pʲ ɛ r ʂ a ɣ a t u n k ɔ v ɨ
небасхіл	nʲ ɛ b a s xʲ i ɫ
павільгатнець	p a vʲ i lʲ ɣ a t nʲ ɛ t͡sʲ
ятроўка	j a t r ɔ w k a
разрыўка	r a z r ɨ w k a
разгародка	r a z ɣ a r ɔ d k a
заціск	z a t͡sʲ i s k
кнігаўка	k nʲ i ɣ a w k a
пазнішчаць	p a zʲ nʲ i ʂ t͡ʂ a t͡sʲ
кідальны	kʲ i d a lʲ n ɨ
параўнанне	p a r a w n a nʲː ɛ
тэрміновы	t ɛ r mʲ i n ɔ v ɨ
падрадкоўнік	p a d r a d k ɔ w nʲ i k
сямейны	sʲ a mʲ ɛ j n ɨ
бесстаронні	bʲ ɛ s s t a r ɔ nʲː i
дзеепрыслоўе	d͡zʲ ɛ j ɛ p r ɨ s ɫ ɔ w j ɛ
размежавальнік	r a zʲ mʲ ɛ ʐ a v a lʲ nʲ i k
расплюхаць	r a s p lʲ u x a t͡sʲ
свербігуз	sʲ vʲ ɛ r bʲ i ɣ u z
памкнуцца	p a m k n u t͡sː a
прамоўца	p r a m ɔ w t͡s a
коннік	k ɔ nʲː i k
самападман	s a m a p a d m a n
выпаражніць	v ɨ p a r a ʐ nʲ i t͡sʲ
шолудзі	ʂ ɔ ɫ u d͡zʲ i
жлукціць	ʐ ɫ u k t͡sʲ i t͡sʲ
шальнік	ʂ a lʲ nʲ i k
расхіліць	r a s xʲ i lʲ i t͡sʲ
свідраваць	sʲ vʲ i d r a v a t͡sʲ
стуліць	s t u lʲ i t͡sʲ
вызваліць	v ɨ z v a lʲ i t͡sʲ
становішча	s t a n ɔ vʲ i ʂ t͡ʂ a
даскубці	d a s k u b t͡sʲ i
скорам	s k ɔ r a m
барацьбіт	b a r a t͡sʲ bʲ i t
лоўж	ɫ ɔ w ʐ
пляшка	p lʲ a ʂ k a
напатылічнік	n a p a t ɨ lʲ i t͡ʂ nʲ i k
сасмагнуць	s a s m a ɣ n u t͡sʲ
малакаштоўны	m a ɫ a k a ʂ t ɔ w n ɨ
спалучальны	s p a ɫ u t͡ʂ a lʲ n ɨ
прыхарашыць	p r ɨ x a r a ʂ ɨ t͡sʲ
часіна	t͡ʂ a sʲ i n a
выклікаць	v ɨ k lʲ i k a t͡sʲ
зеляніна	zʲ ɛ lʲ a nʲ i n a
змярцвіць	zʲ mʲ a r t͡sʲ vʲ i t͡sʲ
пашанаваць	p a ʂ a n a v a t͡sʲ
дзесяцігодка	d͡zʲ ɛ sʲ a t͡sʲ i ɣ ɔ d k a
самадзейнасць	s a m a d͡zʲ ɛ j n a sʲ t͡sʲ
котлішча	k ɔ t lʲ i ʂ t͡ʂ a
прапушчальнасць	p r a p u ʂ t͡ʂ a lʲ n a sʲ t͡sʲ
захапіцца	z a x a pʲ i t͡sː a
вабіць	v a bʲ i t͡sʲ
раўнадушша	r a w n a d u ʂ ʂ a
спрасціць	s p r a sʲ t͡sʲ i t͡sʲ
скурка	s k u r k a
мэтанакіраваны	m ɛ t a n a kʲ i r a v a n ɨ
усходы	u s x ɔ d ɨ
штогадзінны	ʂ t ɔ ɣ a d͡zʲ i nː ɨ
ропа	r ɔ p a
сцілка	sʲ t͡sʲ i ɫ k a
давідна	d a vʲ i d n a
папесціць	p a pʲ ɛ sʲ t͡sʲ i t͡sʲ
паўшчуваць	p a w ʂ t͡ʂ u v a t͡sʲ
дзяўбок	d͡zʲ a w b ɔ k
цягаць	t͡sʲ a ɣ a t͡sʲ
вартаўнік	v a r t a w nʲ i k
прабачаць	p r a b a t͡ʂ a t͡sʲ
разжаліць	r a z ʐ a lʲ i t͡sʲ
рупіцца	r u pʲ i t͡sː a
абіркі	a bʲ i r kʲ i
фарсіць	f a r sʲ i t͡sʲ
паразмалёўваць	p a r a z m a lʲ ɔ w v a t͡sʲ
нахіл	n a xʲ i ɫ
прадмет	p r a d mʲ ɛ t
расчухаць	r a s t͡ʂ u x a t͡sʲ
сон	s ɔ n
баваўняны	b a v a w nʲ a n ɨ
сплюшчыць	s p lʲ u ʂ t͡ʂ ɨ t͡sʲ
паўналецце	p a w n a lʲ ɛ t͡sʲː ɛ
мінаць	mʲ i n a t͡sʲ
харчавік	x a r t͡ʂ a vʲ i k
усеўладдзе	u sʲ ɛ w ɫ a d͡zʲː ɛ
рыбагадавальнік	r ɨ b a ɣ a d a v a lʲ nʲ i k
прымудрыцца	p r ɨ m u d r ɨ t͡sː a
чутны	t͡ʂ u t n ɨ
драўніна	d r a w nʲ i n a
допіс	d ɔ pʲ i s
выцінанкі	v ɨ t͡sʲ i n a n kʲ i
імшара	i m ʂ a r a
маўленне	m a w lʲ ɛ nʲː ɛ
стрымгалоў	s t r ɨ m ɣ a ɫ ɔ w
адліга	a d lʲ i ɣ a
партыя	p a r t ɨ j a
надпаліць	n a d p a lʲ i t͡sʲ
інакш	i n a k ʂ
паштоўка	p a ʂ t ɔ w k a
урвіцель	u r vʲ i t͡sʲ ɛ lʲ
шматмоўе	ʂ m a t m ɔ w j ɛ
узор	u z ɔ r
логавішча	ɫ ɔ ɣ a vʲ i ʂ t͡ʂ a
пассоўваць	p a s s ɔ w v a t͡sʲ
навыдзёўбваць	n a v ɨ d͡zʲ ɔ w b v a t͡sʲ
паўладарыць	p a w ɫ a d a r ɨ t͡sʲ
унук	u n u k
узбоўтаць	u z b ɔ w t a t͡sʲ
ліхвяр	lʲ i x vʲ a r
скуголіць	s k u ɣ ɔ lʲ i t͡sʲ
раскідвальнік	r a s kʲ i d v a lʲ nʲ i k
датэрміновы	d a t ɛ r mʲ i n ɔ v ɨ
утлумачыць	u t ɫ u m a t͡ʂ ɨ t͡sʲ
знясілець	zʲ nʲ a sʲ i lʲ ɛ t͡sʲ
хворасць	x v ɔ r a sʲ t͡sʲ
вясельнік	vʲ a sʲ ɛ lʲ nʲ i k
плёснуць	p lʲ ɔ s n u t͡sʲ
струмень	s t r u mʲ ɛ nʲ
баршчэўнік	b a r ʂ t͡ʂ ɛ w nʲ i k
уздрыг	u z d r ɨ ɣ
безгустоўнасць	bʲ ɛ z ɣ u s t ɔ w n a sʲ t͡sʲ
панагадоўваць	p a n a ɣ a d ɔ w v a t͡sʲ
засяродзіць	z a sʲ a r ɔ d͡zʲ i t͡sʲ
раптоўны	r a p t ɔ w n ɨ
карбідка	k a r bʲ i d k a
сілкаваць	sʲ i ɫ k a v a t͡sʲ
кустоўе	k u s t ɔ w j ɛ
неўласцівы	nʲ ɛ w ɫ a sʲ t͡sʲ i v ɨ
дзяцінства	d͡zʲ a t͡sʲ i n s t v a
сабака	s a b a k a
цемрашал	t͡sʲ ɛ m r a ʂ a ɫ
выключальнік	v ɨ k lʲ u t͡ʂ a lʲ nʲ i k
рыззё	r ɨ zʲː ɔ
святочны	sʲ vʲ a t ɔ t͡ʂ n ɨ
ружавець	r u ʐ a vʲ ɛ t͡sʲ
праскварыць	p r a s k v a r ɨ t͡sʲ
перадапошні	pʲ ɛ r a d a p ɔ ʂ nʲ i
аднамоўны	a d n a m ɔ w n ɨ
палітвязень	p a lʲ i t vʲ a zʲ ɛ nʲ
чэсанкі	t͡ʂ ɛ s a n kʲ i
уссунуць	u s s u n u t͡sʲ
антыграмадскі	a n t ɨ ɣ r a m a d s kʲ i
адтуліна	a d t u lʲ i n a
бязвокі	bʲ a z v ɔ kʲ i
прывэндзіць	p r ɨ v ɛ n d͡zʲ i t͡sʲ
няўчасны	nʲ a w t͡ʂ a s n ɨ
наабгаблёўваць	n a a b ɣ a b lʲ ɔ w v a t͡sʲ
высвідраваць	v ɨ sʲ vʲ i d r a v a t͡sʲ
разрахаваць	r a z r a x a v a t͡sʲ
скразны	s k r a z n ɨ
спакваля	s p a k v a lʲ a
нізкаякасны	nʲ i z k a j a k a s n ɨ
страўнік	s t r a w nʲ i k
яшчарка	j a ʂ t͡ʂ a r k a
углыбіню	u ɣ ɫ ɨ bʲ i nʲ u
адмоўе	a d m ɔ w j ɛ
разгадаваць	r a z ɣ a d a v a t͡sʲ
пагадзінна	p a ɣ a d͡zʲ i nː a
паразблытваць	p a r a z b ɫ ɨ t v a t͡sʲ
спаборніцтва	s p a b ɔ r nʲ i t͡s t v a
суцішыць	s u t͡sʲ i ʂ ɨ t͡sʲ
коцік	k ɔ t͡sʲ i k
выстаўны	v ɨ s t a w n ɨ
зарубіць	z a r u bʲ i t͡sʲ
каморнік	k a m ɔ r nʲ i k
урок	u r ɔ k
шпакоўня	ʂ p a k ɔ w nʲ a
аўтамастэрня	a w t a m a s t ɛ r nʲ a
тры	t r ɨ
прысадзісты	p r ɨ s a d͡zʲ i s t ɨ
ліхі	lʲ i xʲ i
дзіркаваты	d͡zʲ i r k a v a t ɨ
безаблічнасць	bʲ ɛ z a b lʲ i t͡ʂ n a sʲ t͡sʲ
выклікнуць	v ɨ k lʲ i k n u t͡sʲ
ядловец	j a d ɫ ɔ vʲ ɛ t͡s
роздум	r ɔ z d u m
пхаць	p x a t͡sʲ
пострах	p ɔ s t r a x
пазацыроўваць	p a z a t͡s ɨ r ɔ w v a t͡sʲ
залвіца	z a ɫ vʲ i t͡s a
адрозніць	a d r ɔ zʲ nʲ i t͡sʲ
знікнуць	zʲ nʲ i k n u t͡sʲ
свідравальны	sʲ vʲ i d r a v a lʲ n ɨ
панурысты	p a n u r ɨ s t ɨ
падначаліць	p a d n a t͡ʂ a lʲ i t͡sʲ
помсціць	p ɔ m sʲ t͡sʲ i t͡sʲ
паадшрубоўваць	p a a d ʂ r u b ɔ w v a t͡sʲ
завушніца	z a v u ʂ nʲ i t͡s a
пажлукціць	p a ʐ ɫ u k t͡sʲ i t͡sʲ
струна	s t r u n a
твань	t v a nʲ
сцяжына	sʲ t͡sʲ a ʐ ɨ n a
таўшчэзны	t a w ʂ t͡ʂ ɛ z n ɨ
шаноўны	ʂ a n ɔ w n ɨ
уломак	u ɫ ɔ m a k
удавец	u d a vʲ ɛ t͡s
выцінаць	v ɨ t͡sʲ i n a t͡sʲ
запасвіць	z a p a sʲ vʲ i t͡sʲ
кпіны	k pʲ i n ɨ
здрабніць	z d r a b nʲ i t͡sʲ
абразкі	a b r a z kʲ i
трывожыцца	t r ɨ v ɔ ʐ ɨ t͡sː a
скуліць	s k u lʲ i t͡sʲ
плывец	p ɫ ɨ vʲ ɛ t͡s
разнамыснасць	r a z n a m ɨ s n a sʲ t͡sʲ
застоліць	z a s t ɔ lʲ i t͡sʲ
ашалёўка	a ʂ a lʲ ɔ w k a
малаістотны	m a ɫ a j i s t ɔ t n ɨ
пара	p a r a
імкненне	i m k nʲ ɛ nʲː ɛ
мэдлік	m ɛ d lʲ i k
разрабаваць	r a z r a b a v a t͡sʲ
пераўзброіць	pʲ ɛ r a w z b r ɔ j i t͡sʲ
фасоля	f a s ɔ lʲ a
узыходжанне	u z ɨ x ɔ d ʐ a nʲː ɛ
услон	u s ɫ ɔ n
пакратаць	p a k r a t a t͡sʲ
ілжывы	i ɫ ʐ ɨ v ɨ
супрацьпаставіць	s u p r a t͡sʲ p a s t a vʲ i t͡sʲ
сыскаць	s ɨ s k a t͡sʲ
абцінак	a b t͡sʲ i n a k
наскубці	n a s k u b t͡sʲ i
прырода	p r ɨ r ɔ d a
пазагартоўваць	p a z a ɣ a r t ɔ w v a t͡sʲ
шпулька	ʂ p u lʲ k a
распрацоўка	r a s p r a t͡s ɔ w k a
падалешнік	p a d a lʲ ɛ ʂ nʲ i k
западзіна	z a p a d͡zʲ i n a
світанне	sʲ vʲ i t a nʲː ɛ
кнігарня	k nʲ i ɣ a r nʲ a
хата	x a t a
сапхнуць	s a p x n u t͡sʲ
расшмаргнуць	r a s ʂ m a r ɣ n u t͡sʲ
жоўць	ʐ ɔ w t͡sʲ
пільсць	pʲ i lʲ sʲ t͡sʲ
вуркатлівы	v u r k a t lʲ i v ɨ
запаліць	z a p a lʲ i t͡sʲ
пакутнік	p a k u t nʲ i k
пачастунак	p a t͡ʂ a s t u n a k
пазавіхацца	p a z a vʲ i x a t͡sː a
здаволіць	z d a v ɔ lʲ i t͡sʲ
крыўдлівы	k r ɨ w d lʲ i v ɨ
сем	sʲ ɛ m
прылучыць	p r ɨ ɫ u t͡ʂ ɨ t͡sʲ
канаплянішча	k a n a p lʲ a nʲ i ʂ t͡ʂ a
лічба	lʲ i t͡ʂ b a
лупіна	ɫ u pʲ i n a
пашатраваць	p a ʂ a t r a v a t͡sʲ
дрогкі	d r ɔ ɣ kʲ i
пасваволіць	p a s v a v ɔ lʲ i t͡sʲ
азагаловіць	a z a ɣ a ɫ ɔ vʲ i t͡sʲ
падгаліна	p a d ɣ a lʲ i n a
выскаліцца	v ɨ s k a lʲ i t͡sː a
пяцірадкоўе	pʲ a t͡sʲ i r a d k ɔ w j ɛ
панаскрабаць	p a n a s k r a b a t͡sʲ
страсянуць	s t r a sʲ a n u t͡sʲ
трымальнік	t r ɨ m a lʲ nʲ i k
самотнічаць	s a m ɔ t nʲ i t͡ʂ a t͡sʲ
смажаніна	s m a ʐ a nʲ i n a
адлінеіць	a d lʲ i nʲ ɛ j i t͡sʲ
употайкі	u p ɔ t a j kʲ i
папахварэць	p a p a x v a r ɛ t͡sʲ
улічыць	u lʲ i t͡ʂ ɨ t͡sʲ
плыткі	p ɫ ɨ t kʲ i
паспілоўваць	p a sʲ pʲ i ɫ ɔ w v a t͡sʲ
змешвальнік	zʲ mʲ ɛ ʂ v a lʲ nʲ i k
носьбіт	n ɔ sʲ bʲ i t
гарачлівасць	ɣ a r a t͡ʂ lʲ i v a sʲ t͡sʲ
дзіўны	d͡zʲ i w n ɨ
лаўка	ɫ a w k a
цудоўны	t͡s u d ɔ w n ɨ
драпіна	d r a pʲ i n a
гаспадарлівы	ɣ a s p a d a r lʲ i v ɨ
па-драпежніцку	p a - d r a pʲ ɛ ʐ nʲ i t͡s k u
узаемадапамога	u z a j ɛ m a d a p a m ɔ ɣ a
падшэўка	p a d ʂ ɛ w k a
папаездзіць	p a p a j ɛ z d͡zʲ i t͡sʲ
ражон	r a ʐ ɔ n
металазнаўства	mʲ ɛ t a ɫ a z n a w s t v a
першаадкрывальнік	pʲ ɛ r ʂ a a d k r ɨ v a lʲ nʲ i k
папулярны	p a p u lʲ a r n ɨ
таварыскасць	t a v a r ɨ s k a sʲ t͡sʲ
прырэйкавы	p r ɨ r ɛ j k a v ɨ
рыхтык	r ɨ x t ɨ k
пранізлівы	p r a nʲ i zʲ lʲ i v ɨ
пужаць	p u ʐ a t͡sʲ
своекарыслівы	s v ɔ j ɛ k a r ɨ sʲ lʲ i v ɨ
адгалінаваны	a d ɣ a lʲ i n a v a n ɨ
спярэсціць	sʲ pʲ a r ɛ sʲ t͡sʲ i t͡sʲ
псота	p s ɔ t a
слухач	s ɫ u x a t͡ʂ
перапаліць	pʲ ɛ r a p a lʲ i t͡sʲ
сіло	sʲ i ɫ ɔ
будаўніцтва	b u d a w nʲ i t͡s t v a
пашкрабаць	p a ʂ k r a b a t͡sʲ
імгненне	i m ɣ nʲ ɛ nʲː ɛ
адносіны	a d n ɔ sʲ i n ɨ
з’едлівы	z j ɛ d lʲ i v ɨ
разгультаіцца	r a z ɣ u lʲ t a j i t͡sː a
лупіцца	ɫ u pʲ i t͡sː a
змілавацца	zʲ mʲ i ɫ a v a t͡sː a
кідаць	kʲ i d a t͡sʲ
відавочны	vʲ i d a v ɔ t͡ʂ n ɨ
сам	s a m
семя	sʲ ɛ mʲ a
накпіць	n a k pʲ i t͡sʲ
дасвідраваць	d a sʲ vʲ i d r a v a t͡sʲ
умакрэць	u m a k r ɛ t͡sʲ
пакупнік	p a k u p nʲ i k
праціснуць	p r a t͡sʲ i s n u t͡sʲ
гадзіць	ɣ a d͡zʲ i t͡sʲ
згарбаціць	z ɣ a r b a t͡sʲ i t͡sʲ
мясціцца	mʲ a sʲ t͡sʲ i t͡sː a
абагуліць	a b a ɣ u lʲ i t͡sʲ
спырскаць	s p ɨ r s k a t͡sʲ
тэлевежа	t ɛ lʲ ɛ vʲ ɛ ʐ a
тут	t u t
пажадлівы	p a ʐ a d lʲ i v ɨ
хованка	x ɔ v a n k a
прапільнаваць	p r a pʲ i lʲ n a v a t͡sʲ
замігцець	z a mʲ i ɣ t͡sʲ ɛ t͡sʲ
паспрачацца	p a s p r a t͡ʂ a t͡sː a
паўхвіліны	p a w x vʲ i lʲ i n ɨ
строй	s t r ɔ j
член	t͡ʂ lʲ ɛ n
чорны	t͡ʂ ɔ r n ɨ
паўкаштоўны	p a w k a ʂ t ɔ w n ɨ
беспадстаўны	bʲ ɛ s p a d s t a w n ɨ
змерці	zʲ mʲ ɛ r t͡sʲ i
клікаць	k lʲ i k a t͡sʲ
поціск	p ɔ t͡sʲ i s k
змовіны	z m ɔ vʲ i n ɨ
скрыль	s k r ɨ lʲ
запрацівіцца	z a p r a t͡sʲ i vʲ i t͡sː a
расцяць	r a sʲ t͡sʲ a t͡sʲ
заменнік	z a mʲ ɛ nʲː i k
спарыцца	s p a r ɨ t͡sː a
забіць	z a bʲ i t͡sʲ
шасцігадовы	ʂ a sʲ t͡sʲ i ɣ a d ɔ v ɨ
задоўгі	z a d ɔ w ɣʲ i
шанцаваць	ʂ a n t͡s a v a t͡sʲ
позва	p ɔ z v a
расчытаць	r a s t͡ʂ ɨ t a t͡sʲ
таннець	t a nʲː ɛ t͡sʲ
падхінаць	p a d xʲ i n a t͡sʲ
прыстрашыць	p r ɨ s t r a ʂ ɨ t͡sʲ
шыбеніца	ʂ ɨ bʲ ɛ nʲ i t͡s a
алеістасць	a lʲ ɛ j i s t a sʲ t͡sʲ
панамульваць	p a n a m u lʲ v a t͡sʲ
спачынак	s p a t͡ʂ ɨ n a k
знерухоміць	zʲ nʲ ɛ r u x ɔ mʲ i t͡sʲ
гіз	ɣʲ i z
шараваць	ʂ a r a v a t͡sʲ
хітрун	xʲ i t r u n
змесціва	zʲ mʲ ɛ sʲ t͡sʲ i v a
ткацтва	t k a t͡s t v a
усталяваць	u s t a lʲ a v a t͡sʲ
спарыць	s p a r ɨ t͡sʲ
уклінаваць	u k lʲ i n a v a t͡sʲ
жывіцца	ʐ ɨ vʲ i t͡sː a
улоўнік	u ɫ ɔ w nʲ i k
укалыхаць	u k a ɫ ɨ x a t͡sʲ
займеннік	z a j mʲ ɛ nʲː i k
пранізаць	p r a nʲ i z a t͡sʲ
арэлі	a r ɛ lʲ i
перац	pʲ ɛ r a t͡s
паўсвядомы	p a w sʲ vʲ a d ɔ m ɨ
пужацца	p u ʐ a t͡sː a
непахісны	nʲ ɛ p a xʲ i s n ɨ
розначытанне	r ɔ z n a t͡ʂ ɨ t a nʲː ɛ
назалічваць	n a z a lʲ i t͡ʂ v a t͡sʲ
цёплы	t͡sʲ ɔ p ɫ ɨ
тузаніна	t u z a nʲ i n a
пасяджэнне	p a sʲ a d ʐ ɛ nʲː ɛ
перабрудзіць	pʲ ɛ r a b r u d͡zʲ i t͡sʲ
скеміць	s kʲ ɛ mʲ i t͡sʲ
прадпрыемец	p r a d p r ɨ j ɛ mʲ ɛ t͡s
усхапіцца	u s x a pʲ i t͡sː a
самаўхіленне	s a m a w xʲ i lʲ ɛ nʲː ɛ
ілжэсведка	i ɫ ʐ ɛ sʲ vʲ ɛ d k a
прыклетак	p r ɨ k lʲ ɛ t a k
вопіс	v ɔ pʲ i s
імжа	i m ʐ a
баравік	b a r a vʲ i k
ядкі	j a d kʲ i
пяцца	pʲ a t͡sː a
піпка	pʲ i p k a
відазмяняць	vʲ i d a zʲ mʲ a nʲ a t͡sʲ
пчалярства	p t͡ʂ a lʲ a r s t v a
разумніца	r a z u m nʲ i t͡s a
уваход	u v a x ɔ d
праззяць	p r a zʲː a t͡sʲ
перавытворчасць	pʲ ɛ r a v ɨ t v ɔ r t͡ʂ a sʲ t͡sʲ
сад	s a d
падкітаваць	p a d kʲ i t a v a t͡sʲ
футбол	f u t b ɔ ɫ
пазаплюшчваць	p a z a p lʲ u ʂ t͡ʂ v a t͡sʲ
жвір	ʐ vʲ i r
дзесяціборства	d͡zʲ ɛ sʲ a t͡sʲ i b ɔ r s t v a
іншы	i n ʂ ɨ
пастава	p a s t a v a
умлець	u m lʲ ɛ t͡sʲ
хлапечнік	x ɫ a pʲ ɛ t͡ʂ nʲ i k
свабода	s v a b ɔ d a
прыгляд	p r ɨ ɣ lʲ a d
соўгацца	s ɔ w ɣ a t͡sː a
джаліць	d ʐ a lʲ i t͡sʲ
падахвоціць	p a d a x v ɔ t͡sʲ i t͡sʲ
яечня	j a j ɛ t͡ʂ nʲ a
прагавіты	p r a ɣ a vʲ i t ɨ
стогадовы	s t ɔ ɣ a d ɔ v ɨ
прамаці	p r a m a t͡sʲ i
напаўспелы	n a p a w sʲ pʲ ɛ ɫ ɨ
халодны	x a ɫ ɔ d n ɨ
сартаваць	s a r t a v a t͡sʲ
пазахопліваць	p a z a x ɔ p lʲ i v a t͡sʲ
цяміць	t͡sʲ a mʲ i t͡sʲ
трыпутнік	t r ɨ p u t nʲ i k
палонка	p a ɫ ɔ n k a
абмінуць	a b mʲ i n u t͡sʲ
падхапіць	p a d x a pʲ i t͡sʲ
змізарнець	zʲ mʲ i z a r nʲ ɛ t͡sʲ
чыншавік	t͡ʂ ɨ n ʂ a vʲ i k
хіб	xʲ i b
пражытак	p r a ʐ ɨ t a k
укладальнік	u k ɫ a d a lʲ nʲ i k
пасхіляць	p a s xʲ i lʲ a t͡sʲ
калякветнік	k a lʲ a k vʲ ɛ t nʲ i k
перашкліць	pʲ ɛ r a ʂ k lʲ i t͡sʲ
шалпатаць	ʂ a ɫ p a t a t͡sʲ
шруба	ʂ r u b a
збавіць	z b a vʲ i t͡sʲ
гліцэрына	ɣ lʲ i t͡s ɛ r ɨ n a
перапёлачнік	pʲ ɛ r a pʲ ɔ ɫ a t͡ʂ nʲ i k
папашараваць	p a p a ʂ a r a v a t͡sʲ
выраніць	v ɨ r a nʲ i t͡sʲ
патузаць	p a t u z a t͡sʲ
краіна	k r a j i n a
прапаліць	p r a p a lʲ i t͡sʲ
пераўтварыць	pʲ ɛ r a w t v a r ɨ t͡sʲ
пазычыць	p a z ɨ t͡ʂ ɨ t͡sʲ
шост	ʂ ɔ s t
раіцца	r a j i t͡sː a
бацвінне	b a t͡sʲ vʲ i nʲː ɛ
выпыліць	v ɨ p ɨ lʲ i t͡sʲ
схуднець	s x u d nʲ ɛ t͡sʲ
перагляд	pʲ ɛ r a ɣ lʲ a d
няўжо	nʲ a w ʐ ɔ
паштурхаць	p a ʂ t u r x a t͡sʲ
штуршок	ʂ t u r ʂ ɔ k
вадаёмішча	v a d a j ɔ mʲ i ʂ t͡ʂ a
жахлівы	ʐ a x lʲ i v ɨ
ужаць	u ʐ a t͡sʲ
працяжнік	p r a t͡sʲ a ʐ nʲ i k
стрэсціся	s t r ɛ sʲ t͡sʲ i sʲ a
цяжкавымоўны	t͡sʲ a ʐ k a v ɨ m ɔ w n ɨ
рушыць	r u ʂ ɨ t͡sʲ
праспяваць	p r a sʲ pʲ a v a t͡sʲ
пасашпільваць	p a s a ʂ pʲ i lʲ v a t͡sʲ
прыгажэць	p r ɨ ɣ a ʐ ɛ t͡sʲ
лістоўніца	lʲ i s t ɔ w nʲ i t͡s a
браднік	b r a d nʲ i k
наймальнік	n a j m a lʲ nʲ i k
казеліць	k a zʲ ɛ lʲ i t͡sʲ
недалічыць	nʲ ɛ d a lʲ i t͡ʂ ɨ t͡sʲ
запатрабаванні	z a p a t r a b a v a nʲː i
запальніца	z a p a lʲ nʲ i t͡s a
палятуха	p a lʲ a t u x a
спляміць	s p lʲ a mʲ i t͡sʲ
абшэўка	a b ʂ ɛ w k a
здзеклівы	z d͡zʲ ɛ k lʲ i v ɨ
абкоўзаць	a b k ɔ w z a t͡sʲ
зашкліць	z a ʂ k lʲ i t͡sʲ
хваравіты	x v a r a vʲ i t ɨ
заскуголіць	z a s k u ɣ ɔ lʲ i t͡sʲ
распытаць	r a s p ɨ t a t͡sʲ
наблізіць	n a b lʲ i zʲ i t͡sʲ
мімаволі	mʲ i m a v ɔ lʲ i
стравіць	s t r a vʲ i t͡sʲ
літаратуразнаўца	lʲ i t a r a t u r a z n a w t͡s a
пераклад	pʲ ɛ r a k ɫ a d
прадстаўніцтва	p r a d s t a w nʲ i t͡s t v a
выклік	v ɨ k lʲ i k
змірыцца	zʲ mʲ i r ɨ t͡sː a
забаўляць	z a b a w lʲ a t͡sʲ
сквар	s k v a r
самаўпэўненасць	s a m a w p ɛ w nʲ ɛ n a sʲ t͡sʲ
дзе-нідзе	d͡zʲ ɛ - nʲ i d͡zʲ ɛ
спрашчэнства	s p r a ʂ t͡ʂ ɛ n s t v a
шыпшыннік	ʂ ɨ p ʂ ɨ nʲː i k
ёмкі	j ɔ m kʲ i
паглуміцца	p a ɣ ɫ u mʲ i t͡sː a
покліч	p ɔ k lʲ i t͡ʂ
флянс	f lʲ a n s
літасць	lʲ i t a sʲ t͡sʲ
ухадзіцца	u x a d͡zʲ i t͡sː a
пасцерагчы	p a sʲ t͡sʲ ɛ r a ɣ t͡ʂ ɨ
слухаць	s ɫ u x a t͡sʲ
пашараваць	p a ʂ a r a v a t͡sʲ
змігнуць	zʲ mʲ i ɣ n u t͡sʲ
каласавік	k a ɫ a s a vʲ i k
правалтузіцца	p r a v a ɫ t u zʲ i t͡sː a
імга	i m ɣ a
праракаць	p r a r a k a t͡sʲ
папалохаць	p a p a ɫ ɔ x a t͡sʲ
рамізнік	r a mʲ i zʲ nʲ i k
суняць	s u nʲ a t͡sʲ
дапасці	d a p a sʲ t͡sʲ i
дзесяцігоддзе	d͡zʲ ɛ sʲ a t͡sʲ i ɣ ɔ d͡zʲː ɛ
недаедкі	nʲ ɛ d a j ɛ d kʲ i
паплеціна	p a p lʲ ɛ t͡sʲ i n a
недаціснуць	nʲ ɛ d a t͡sʲ i s n u t͡sʲ
дапільнаваць	d a pʲ i lʲ n a v a t͡sʲ
супрацоўніцтва	s u p r a t͡s ɔ w nʲ i t͡s t v a
памужнець	p a m u ʐ nʲ ɛ t͡sʲ
усёмагутны	u sʲ ɔ m a ɣ u t n ɨ
пакуродыміць	p a k u r ɔ d ɨ mʲ i t͡sʲ
слівень	sʲ lʲ i vʲ ɛ nʲ
рыдлёўка	r ɨ d lʲ ɔ w k a
расчыніць	r a s t͡ʂ ɨ nʲ i t͡sʲ
укладаць	u k ɫ a d a t͡sʲ
лупцоўка	ɫ u p t͡s ɔ w k a
кіраванне	kʲ i r a v a nʲː ɛ
дапаліць	d a p a lʲ i t͡sʲ
стала	s t a ɫ a
умайстраваць	u m a j s t r a v a t͡sʲ
крупнік	k r u p nʲ i k
закуродыміць	z a k u r ɔ d ɨ mʲ i t͡sʲ
пакласці	p a k ɫ a sʲ t͡sʲ i
ужыць	u ʐ ɨ t͡sʲ
прасвідраваць	p r a sʲ vʲ i d r a v a t͡sʲ
спаласкаць	s p a ɫ a s k a t͡sʲ
усватаць	u s v a t a t͡sʲ
перабольшыць	pʲ ɛ r a b ɔ lʲ ʂ ɨ t͡sʲ
лёдаўтварэнне	lʲ ɔ d a w t v a r ɛ nʲː ɛ
бярозавік	bʲ a r ɔ z a vʲ i k
чаўрэць	t͡ʂ a w r ɛ t͡sʲ
сумысны	s u m ɨ s n ɨ
пагінуць	p a ɣʲ i n u t͡sʲ
разгойдваць	r a z ɣ ɔ j d v a t͡sʲ
абвясціць	a b vʲ a sʲ t͡sʲ i t͡sʲ
паддубовік	p a d d u b ɔ vʲ i k
леснічоўка	lʲ ɛ sʲ nʲ i t͡ʂ ɔ w k a
справаводства	s p r a v a v ɔ d s t v a
слізгаць	sʲ lʲ i z ɣ a t͡sʲ
дацерці	d a t͡sʲ ɛ r t͡sʲ i
абражальнік	a b r a ʐ a lʲ nʲ i k
ільнянішча	i lʲ nʲ a nʲ i ʂ t͡ʂ a
пакаламуціць	p a k a ɫ a m u t͡sʲ i t͡sʲ
змястоўны	zʲ mʲ a s t ɔ w n ɨ
галіць	ɣ a lʲ i t͡sʲ
чэзнуць	t͡ʂ ɛ z n u t͡sʲ
сямігоддзе	sʲ a mʲ i ɣ ɔ d͡zʲː ɛ
павялічыць	p a vʲ a lʲ i t͡ʂ ɨ t͡sʲ
вячоркі	vʲ a t͡ʂ ɔ r kʲ i
лісяня	lʲ i sʲ a nʲ a
задаволіць	z a d a v ɔ lʲ i t͡sʲ
сямітыднёвы	sʲ a mʲ i t ɨ d nʲ ɔ v ɨ
закаламуціць	z a k a ɫ a m u t͡sʲ i t͡sʲ
урабіць	u r a bʲ i t͡sʲ
удзельнасць	u d͡zʲ ɛ lʲ n a sʲ t͡sʲ
таваразнавец	t a v a r a z n a vʲ ɛ t͡s
учатырох	u t͡ʂ a t ɨ r ɔ x
шарош	ʂ a r ɔ ʂ
замігацець	z a mʲ i ɣ a t͡sʲ ɛ t͡sʲ
учэпісты	u t͡ʂ ɛ pʲ i s t ɨ
увечар	u vʲ ɛ t͡ʂ a r
пачуць	p a t͡ʂ u t͡sʲ
калідор	k a lʲ i d ɔ r
сарамлівы	s a r a m lʲ i v ɨ
наўскасяк	n a w s k a sʲ a k
заслізгаць	z a sʲ lʲ i z ɣ a t͡sʲ
мігацець	mʲ i ɣ a t͡sʲ ɛ t͡sʲ
пакітаваць	p a kʲ i t a v a t͡sʲ
запіс	z a pʲ i s
згінуць	z ɣʲ i n u t͡sʲ
жыціца	ʐ ɨ t͡sʲ i t͡s a
падсківічны	p a d s kʲ i vʲ i t͡ʂ n ɨ
паклады	p a k ɫ a d ɨ
каўка	k a w k a
шпацыраваць	ʂ p a t͡s ɨ r a v a t͡sʲ
прыточка	p r ɨ t ɔ t͡ʂ k a
халат	x a ɫ a t
няўзнак	nʲ a w z n a k
выслабаніць	v ɨ s ɫ a b a nʲ i t͡sʲ
таварыш	t a v a r ɨ ʂ
тлумачальнік	t ɫ u m a t͡ʂ a lʲ nʲ i k
уседлівы	u sʲ ɛ d lʲ i v ɨ
ахапіць	a x a pʲ i t͡sʲ
асьміна	a sʲ mʲ i n a
перапудзіць	pʲ ɛ r a p u d͡zʲ i t͡sʲ
прыкмеціць	p r ɨ k mʲ ɛ t͡sʲ i t͡sʲ
зычлівец	z ɨ t͡ʂ lʲ i vʲ ɛ t͡s
куродыміць	k u r ɔ d ɨ mʲ i t͡sʲ
выкалаціць	v ɨ k a ɫ a t͡sʲ i t͡sʲ
рашэтнік	r a ʂ ɛ t nʲ i k
закілзаць	z a kʲ i ɫ z a t͡sʲ
павыпампоўваць	p a v ɨ p a m p ɔ w v a t͡sʲ
кавярзні	k a vʲ a r zʲ nʲ i
патуральнік	p a t u r a lʲ nʲ i k
збройнік	z b r ɔ j nʲ i k
пасачыць	p a s a t͡ʂ ɨ t͡sʲ
хвойнік	x v ɔ j nʲ i k
паўбіраць	p a w bʲ i r a t͡sʲ
адхіліць	a d xʲ i lʲ i t͡sʲ
прамацаць	p r a m a t͡s a t͡sʲ
абвяшчальнік	a b vʲ a ʂ t͡ʂ a lʲ nʲ i k
унутраны	u n u t r a n ɨ
прыгалоўе	p r ɨ ɣ a ɫ ɔ w j ɛ
бавоўна	b a v ɔ w n a
дапытлівы	d a p ɨ t lʲ i v ɨ
ушрубаваць	u ʂ r u b a v a t͡sʲ
уплыў	u p ɫ ɨ w
раздушыць	r a z d u ʂ ɨ t͡sʲ
сёння	sʲ ɔ nʲː a
прытаўчы	p r ɨ t a w t͡ʂ ɨ
кладоўка	k ɫ a d ɔ w k a
разасяродзіць	r a z a sʲ a r ɔ d͡zʲ i t͡sʲ
птаства	p t a s t v a
страсянуцца	s t r a sʲ a n u t͡sː a
ператаўчы	pʲ ɛ r a t a w t͡ʂ ɨ
удзел	u d͡zʲ ɛ ɫ
змыліць	z m ɨ lʲ i t͡sʲ
выбліск	v ɨ b lʲ i s k
мовазнаўства	m ɔ v a z n a w s t v a
спасылка	s p a s ɨ ɫ k a
напаўкаштоўны	n a p a w k a ʂ t ɔ w n ɨ
утуліць	u t u lʲ i t͡sʲ
перафарбоўка	pʲ ɛ r a f a r b ɔ w k a
дапрацоўка	d a p r a t͡s ɔ w k a
перасягнуць	pʲ ɛ r a sʲ a ɣ n u t͡sʲ
апавясціць	a p a vʲ a sʲ t͡sʲ i t͡sʲ
святаяннік	sʲ vʲ a t a j a nʲː i k
саладзіць	s a ɫ a d͡zʲ i t͡sʲ
з’явіцца	z j a vʲ i t͡sː a
спадарожнік	s p a d a r ɔ ʐ nʲ i k
перагартоўка	pʲ ɛ r a ɣ a r t ɔ w k a
шкліць	ʂ k lʲ i t͡sʲ
упражыць	u p r a ʐ ɨ t͡sʲ
слімак	sʲ lʲ i m a k
зачапіцца	z a t͡ʂ a pʲ i t͡sː a
лялечнік	lʲ a lʲ ɛ t͡ʂ nʲ i k
пудзіла	p u d͡zʲ i ɫ a
веліч	vʲ ɛ lʲ i t͡ʂ
даўкі	d a w kʲ i
пляткарства	p lʲ a t k a r s t v a
самаадчуванне	s a m a a t͡ʂː u v a nʲː ɛ
перапужаць	pʲ ɛ r a p u ʐ a t͡sʲ
светлы	sʲ vʲ ɛ t ɫ ɨ
колішні	k ɔ lʲ i ʂ nʲ i
сучаснік	s u t͡ʂ a sʲ nʲ i k
паліць	p a lʲ i t͡sʲ
угайдаць	u ɣ a j d a t͡sʲ
вандроўка	v a n d r ɔ w k a
шчаўе	ʂ t͡ʂ a w j ɛ
сэрца	s ɛ r t͡s a
засаўка	z a s a w k a
пяць	pʲ a t͡sʲ
вілачнік	vʲ i ɫ a t͡ʂ nʲ i k
схема	s x j ɛ m a
ушчэнт	u ʂ t͡ʂ ɛ n t
перапрацаваць	pʲ ɛ r a p r a t͡s a v a t͡sʲ
паўзмрок	p a w z m r ɔ k
адмоўны	a d m ɔ w n ɨ
сустрэць	s u s t r ɛ t͡sʲ
расхістаць	r a s xʲ i s t a t͡sʲ
прагушкаць	p r a ɣ u ʂ k a t͡sʲ
шпік	ʂ pʲ i k
засмеціць	z a sʲ mʲ ɛ t͡sʲ i t͡sʲ
ахвярнік	a x vʲ a r nʲ i k
ачмуціць	a t͡ʂ m u t͡sʲ i t͡sʲ
навазіцца	n a v a zʲ i t͡sː a
багноўка	b a ɣ n ɔ w k a
пашалець	p a ʂ a lʲ ɛ t͡sʲ
працоўны	p r a t͡s ɔ w n ɨ
перафарбаваць	pʲ ɛ r a f a r b a v a t͡sʲ
абцякальнік	a b t͡sʲ a k a lʲ nʲ i k
прадугледзець	p r a d u ɣ lʲ ɛ d͡zʲ ɛ t͡sʲ
паўпарожні	p a w p a r ɔ ʐ nʲ i
квазізорка	k v a zʲ i z ɔ r k a
плытніцтва	p ɫ ɨ t nʲ i t͡s t v a
хіба	xʲ i b a
змеціць	zʲ mʲ ɛ t͡sʲ i t͡sʲ
палюляць	p a lʲ u lʲ a t͡sʲ
ратавальнік	r a t a v a lʲ nʲ i k
паразбураць	p a r a z b u r a t͡sʲ
сцізорык	sʲ t͡sʲ i z ɔ r ɨ k
пазашрубоўваць	p a z a ʂ r u b ɔ w v a t͡sʲ
пападарожнічаць	p a p a d a r ɔ ʐ nʲ i t͡ʂ a t͡sʲ
пагарэзнічаць	p a ɣ a r ɛ zʲ nʲ i t͡ʂ a t͡sʲ
выкрасіць	v ɨ k r a sʲ i t͡sʲ
асветнік	a sʲ vʲ ɛ t nʲ i k
заахвоціць	z a a x v ɔ t͡sʲ i t͡sʲ
дагаліць	d a ɣ a lʲ i t͡sʲ
ляўконія	lʲ a w k ɔ nʲ i j a
плюшчыць	p lʲ u ʂ t͡ʂ ɨ t͡sʲ
перасвяткаваць	pʲ ɛ r a sʲ vʲ a t k a v a t͡sʲ
шаткаўніца	ʂ a t k a w nʲ i t͡s a
неўзабаве	nʲ ɛ w z a b a vʲ ɛ
клінаваты	k lʲ i n a v a t ɨ
памігацець	p a mʲ i ɣ a t͡sʲ ɛ t͡sʲ
рухавіць	r u x a vʲ i t͡sʲ
кітаваць	kʲ i t a v a t͡sʲ
паэт	p a ɛ t
плюхнуць	p lʲ u x n u t͡sʲ
зацікавіцца	z a t͡sʲ i k a vʲ i t͡sː a
дзельнік	d͡zʲ ɛ lʲ nʲ i k
ядраны	j a d r a n ɨ
маркоціць	m a r k ɔ t͡sʲ i t͡sʲ
расціснуць	r a sʲ t͡sʲ i s n u t͡sʲ
рачулка	r a t͡ʂ u ɫ k a
працяг	p r a t͡sʲ a ɣ
поцемкам	p ɔ t͡sʲ ɛ m k a m
сабе	s a bʲ ɛ
наддзяўбці	n a d͡zʲː a w b t͡sʲ i
пасварыць	p a s v a r ɨ t͡sʲ
пракачацца	p r a k a t͡ʂ a t͡sː a
паспачуваць	p a s p a t͡ʂ u v a t͡sʲ
запаланіць	z a p a ɫ a nʲ i t͡sʲ
стырнік	s t ɨ r nʲ i k
пасунуць	p a s u n u t͡sʲ
свежы	sʲ vʲ ɛ ʐ ɨ
пакалашмаціць	p a k a ɫ a ʂ m a t͡sʲ i t͡sʲ
абвінаваціць	a b vʲ i n a v a t͡sʲ i t͡sʲ
выратавальнік	v ɨ r a t a v a lʲ nʲ i k
прынамсі	p r ɨ n a m sʲ i
спэцкаць	s p ɛ t͡s k a t͡sʲ
бізун	bʲ i z u n
цемнатвары	t͡sʲ ɛ m n a t v a r ɨ
прыкараскацца	p r ɨ k a r a s k a t͡sː a
распыляльнік	r a s p ɨ lʲ a lʲ nʲ i k
бадзяжніцтва	b a d͡zʲ a ʐ nʲ i t͡s t v a
затаўчы	z a t a w t͡ʂ ɨ
пазабудоўваць	p a z a b u d ɔ w v a t͡sʲ
злозычлівы	z ɫ ɔ z ɨ t͡ʂ lʲ i v ɨ
закідаць	z a kʲ i d a t͡sʲ
паўстанне	p a w s t a nʲː ɛ
узбуйніць	u z b u j nʲ i t͡sʲ
абзеляніць	a b zʲ ɛ lʲ a nʲ i t͡sʲ
утрох	u t r ɔ x
сасвідраваць	s a sʲ vʲ i d r a v a t͡sʲ
разняволіць	r a zʲ nʲ a v ɔ lʲ i t͡sʲ
уступ	u s t u p
чутнасць	t͡ʂ u t n a sʲ t͡sʲ
паспадзявацца	p a s p a d͡zʲ a v a t͡sː a
задаўніць	z a d a w nʲ i t͡sʲ
урода	u r ɔ d a
пястун	pʲ a s t u n
кіназнаўства	kʲ i n a z n a w s t v a
дзерці	d͡zʲ ɛ r t͡sʲ i
закалаціцца	z a k a ɫ a t͡sʲ i t͡sː a
кнігасховішча	k nʲ i ɣ a s x ɔ vʲ i ʂ t͡ʂ a
падзяўбці	p a d͡zʲ a w b t͡sʲ i
паспытаць	p a s p ɨ t a t͡sʲ
правішчаць	p r a vʲ i ʂ t͡ʂ a t͡sʲ
устыць	u s t ɨ t͡sʲ
раўці	r a w t͡sʲ i
папячы	p a pʲ a t͡ʂ ɨ
парахманець	p a r a x m a nʲ ɛ t͡sʲ
высмаліць	v ɨ s m a lʲ i t͡sʲ
прывабіць	p r ɨ v a bʲ i t͡sʲ
захістацца	z a xʲ i s t a t͡sː a
урэзак	u r ɛ z a k
святлоўстойлівы	sʲ vʲ a t ɫ ɔ w s t ɔ j lʲ i v ɨ
наталіць	n a t a lʲ i t͡sʲ
нагрувасціць	n a ɣ r u v a sʲ t͡sʲ i t͡sʲ
усмактаць	u s m a k t a t͡sʲ
надмагілле	n a d m a ɣʲ i lʲ lʲ ʲ ɛ
зацішак	z a t͡sʲ i ʂ a k
загусці	z a ɣ u sʲ t͡sʲ i
памяншальнік	p a mʲ a n ʂ a lʲ nʲ i k
сцень	sʲ t͡sʲ ɛ nʲ
упасвіць	u p a sʲ vʲ i t͡sʲ
адшчапіць	a d ʂ t͡ʂ a pʲ i t͡sʲ
адзіны	a d͡zʲ i n ɨ
саўладальнік	s a w ɫ a d a lʲ nʲ i k
хістацца	xʲ i s t a t͡sː a
шчыльны	ʂ t͡ʂ ɨ lʲ n ɨ
выцерабіць	v ɨ t͡sʲ ɛ r a bʲ i t͡sʲ
паўрубель	p a w r u bʲ ɛ lʲ
чытальнік	t͡ʂ ɨ t a lʲ nʲ i k
упарадкаванасць	u p a r a d k a v a n a sʲ t͡sʲ
ёўня	j ɔ w nʲ a
прыкруціць	p r ɨ k r u t͡sʲ i t͡sʲ
небеспадстаўны	nʲ ɛ bʲ ɛ s p a d s t a w n ɨ
паўпаверх	p a w p a vʲ ɛ r x
завінуць	z a vʲ i n u t͡sʲ
дрыготкі	d r ɨ ɣ ɔ t kʲ i
святлоахоўны	sʲ vʲ a t ɫ ɔ a x ɔ w n ɨ
скалмаціць	s k a ɫ m a t͡sʲ i t͡sʲ
угрэбці	u ɣ r ɛ b t͡sʲ i
ікол	i k ɔ ɫ
жнівень	ʐ nʲ i vʲ ɛ nʲ
выкіраваць	v ɨ kʲ i r a v a t͡sʲ
іржэўнікавы	i r ʐ ɛ w nʲ i k a v ɨ
правэндзіць	p r a v ɛ n d͡zʲ i t͡sʲ
паўпляшкі	p a w p lʲ a ʂ kʲ i
уцячы	u t͡sʲ a t͡ʂ ɨ
крыжавік	k r ɨ ʐ a vʲ i k
усебаковы	u sʲ ɛ b a k ɔ v ɨ
атрэсці	a t r ɛ sʲ t͡sʲ i
скубануць	s k u b a n u t͡sʲ
бясхібны	bʲ a s xʲ i b n ɨ
скіраваць	s kʲ i r a v a t͡sʲ
загаўкаць	z a ɣ a w k a t͡sʲ
прымаўка	p r ɨ m a w k a
нагарэзіць	n a ɣ a r ɛ zʲ i t͡sʲ
узгадаваць	u z ɣ a d a v a t͡sʲ
пылавік	p ɨ ɫ a vʲ i k
сцёгны	sʲ t͡sʲ ɔ ɣ n ɨ
злінеіць	zʲ lʲ i nʲ ɛ j i t͡sʲ
мудрагеліць	m u d r a ɣʲ ɛ lʲ i t͡sʲ
пярэзімак	pʲ a r ɛ zʲ i m a k
папярэдні	p a pʲ a r ɛ d nʲ i
назіраць	n a zʲ i r a t͡sʲ
прамігацець	p r a mʲ i ɣ a t͡sʲ ɛ t͡sʲ
прытрымаць	p r ɨ t r ɨ m a t͡sʲ
папрытульваць	p a p r ɨ t u lʲ v a t͡sʲ
вагаўшчык	v a ɣ a w ʂ t͡ʂ ɨ k
устрыманы	u s t r ɨ m a n ɨ
пацалунак	p a t͡s a ɫ u n a k
накрыўка	n a k r ɨ w k a
пачаставаць	p a t͡ʂ a s t a v a t͡sʲ
пісьменства	pʲ i sʲ mʲ ɛ n s t v a
сузіраць	s u zʲ i r a t͡sʲ
лукавіна	ɫ u k a vʲ i n a
запыніць	z a p ɨ nʲ i t͡sʲ
царства	t͡s a r s t v a
беззмястоўнасць	bʲ ɛ zʲː mʲ a s t ɔ w n a sʲ t͡sʲ
разраўнаваць	r a z r a w n a v a t͡sʲ
парэнчы	p a r ɛ n t͡ʂ ɨ
крыўдаваць	k r ɨ w d a v a t͡sʲ
сланечнік	s ɫ a nʲ ɛ t͡ʂ nʲ i k
выцерці	v ɨ t͡sʲ ɛ r t͡sʲ i
падворыўны	p a d v ɔ r ɨ w n ɨ
рацыя	r a t͡s ɨ j a
перакрыжаваць	pʲ ɛ r a k r ɨ ʐ a v a t͡sʲ
памоўка	p a m ɔ w k a
змаркоціцца	z m a r k ɔ t͡sʲ i t͡sː a
працаўнік	p r a t͡s a w nʲ i k
папляміць	p a p lʲ a mʲ i t͡sʲ
радзіць	r a d͡zʲ i t͡sʲ
закоскі	z a k ɔ s kʲ i
гуказапіс	ɣ u k a z a pʲ i s
тэрмін	t ɛ r mʲ i n
пільны	pʲ i lʲ n ɨ
пападсякаць	p a p a d sʲ a k a t͡sʲ
сябраваць	sʲ a b r a v a t͡sʲ
бліскавіца	b lʲ i s k a vʲ i t͡s a
скамячыць	s k a mʲ a t͡ʂ ɨ t͡sʲ
дабудоўка	d a b u d ɔ w k a
узмацнець	u z m a t͡sʲ nʲ ɛ t͡sʲ
шляхетны	ʂ lʲ a x j ɛ t n ɨ
прыціск	p r ɨ t͡sʲ i s k
травень	t r a vʲ ɛ nʲ
староства	s t a r ɔ s t v a
разгляд	r a z ɣ lʲ a d
дзіда	d͡zʲ i d a
хаўкаць	x a w k a t͡sʲ
плытнік	p ɫ ɨ t nʲ i k
уздзейнічаць	u z d͡zʲ ɛ j nʲ i t͡ʂ a t͡sʲ
часопіс	t͡ʂ a s ɔ pʲ i s
падцікаваць	p a d t͡sʲ i k a v a t͡sʲ
нахабнік	n a x a b nʲ i k
перапыніць	pʲ ɛ r a p ɨ nʲ i t͡sʲ
далікацтва	d a lʲ i k a t͡s t v a
сціплы	sʲ t͡sʲ i p ɫ ɨ
пругкі	p r u ɣ kʲ i
таропкі	t a r ɔ p kʲ i
грамадзянін	ɣ r a m a d͡zʲ a nʲ i n
залавіць	z a ɫ a vʲ i t͡sʲ
дольнік	d ɔ lʲ nʲ i k
станоўчы	s t a n ɔ w t͡ʂ ɨ
пражываць	p r a ʐ ɨ v a t͡sʲ
красамоўны	k r a s a m ɔ w n ɨ
узгорысты	u z ɣ ɔ r ɨ s t ɨ
ссунуць	s s u n u t͡sʲ
параўнаць	p a r a w n a t͡sʲ
спіс	sʲ pʲ i s
вадкі	v a d kʲ i
індычына	i n d ɨ t͡ʂ ɨ n a
радоўка	r a d ɔ w k a
журавіны	ʐ u r a vʲ i n ɨ
своеўладства	s v ɔ j ɛ w ɫ a d s t v a
сокат	s ɔ k a t
авечнік	a vʲ ɛ t͡ʂ nʲ i k
поліўка	p ɔ lʲ i w k a
драпежнік	d r a pʲ ɛ ʐ nʲ i k
абняславіць	a b nʲ a s ɫ a vʲ i t͡sʲ
свірэпка	sʲ vʲ i r ɛ p k a
пакрыўдаваць	p a k r ɨ w d a v a t͡sʲ
прыгажосць	p r ɨ ɣ a ʐ ɔ sʲ t͡sʲ
уміг	u mʲ i ɣ
сумесны	s u mʲ ɛ s n ɨ
прачыніць	p r a t͡ʂ ɨ nʲ i t͡sʲ
перапечка	pʲ ɛ r a pʲ ɛ t͡ʂ k a
разгалінаванне	r a z ɣ a lʲ i n a v a nʲː ɛ
закрыўдаваць	z a k r ɨ w d a v a t͡sʲ
скрывавіць	s k r ɨ v a vʲ i t͡sʲ
спалатнець	s p a ɫ a t nʲ ɛ t͡sʲ
чырвонагаловік	t͡ʂ ɨ r v ɔ n a ɣ a ɫ ɔ vʲ i k
узыход	u z ɨ x ɔ d
размывальнік	r a z m ɨ v a lʲ nʲ i k
патроіць	p a t r ɔ j i t͡sʲ
скарбонка	s k a r b ɔ n k a
развітальны	r a zʲ vʲ i t a lʲ n ɨ
згодлівы	z ɣ ɔ d lʲ i v ɨ
сівец	sʲ i vʲ ɛ t͡s
ацішэць	a t͡sʲ i ʂ ɛ t͡sʲ
раскідаць	r a s kʲ i d a t͡sʲ
гутарлівы	ɣ u t a r lʲ i v ɨ
павэндзіць	p a v ɛ n d͡zʲ i t͡sʲ
палягчаць	p a lʲ a ɣ t͡ʂ a t͡sʲ
па-старадаўняму	p a - s t a r a d a w nʲ a m u
зеўра	zʲ ɛ w r a
прадзьмухаць	p r a d zʲ m u x a t͡sʲ
паўвар’ят	p a w v a r j a t
панапэцкваць	p a n a p ɛ t͡s k v a t͡sʲ
расколіна	r a s k ɔ lʲ i n a
утварыць	u t v a r ɨ t͡sʲ
раздурыць	r a z d u r ɨ t͡sʲ
разупэўніць	r a z u p ɛ w nʲ i t͡sʲ
чытаць	t͡ʂ ɨ t a t͡sʲ
прысмаліць	p r ɨ s m a lʲ i t͡sʲ
падарожнік	p a d a r ɔ ʐ nʲ i k
прачакаць	p r a t͡ʂ a k a t͡sʲ
пераўладкаваць	pʲ ɛ r a w ɫ a d k a v a t͡sʲ
іспыт	i s p ɨ t
валатоўка	v a ɫ a t ɔ w k a
адпудзіць	a d p u d͡zʲ i t͡sʲ
перапрацоўка	pʲ ɛ r a p r a t͡s ɔ w k a
салоўка	s a ɫ ɔ w k a
дафарбоўка	d a f a r b ɔ w k a
гіль	ɣʲ i lʲ
укасіць	u k a sʲ i t͡sʲ
сашпіліць	s a ʂ pʲ i lʲ i t͡sʲ
скаламуціць	s k a ɫ a m u t͡sʲ i t͡sʲ
пугаўё	p u ɣ a w j ɔ
імпэт	i m p ɛ t
паспяваць	p a sʲ pʲ a v a t͡sʲ
дагартоўка	d a ɣ a r t ɔ w k a
супрацьслізготны	s u p r a t͡sʲ sʲ lʲ i z ɣ ɔ t n ɨ
заснавальнік	z a s n a v a lʲ nʲ i k
даследнік	d a sʲ lʲ ɛ d nʲ i k
заблізка	z a b lʲ i z k a
саскубці	s a s k u b t͡sʲ i
засваволіць	z a s v a v ɔ lʲ i t͡sʲ
прагнасць	p r a ɣ n a sʲ t͡sʲ
уратаваць	u r a t a v a t͡sʲ
ссінець	sʲː i nʲ ɛ t͡sʲ
гісторыя	ɣʲ i s t ɔ r ɨ j a
ліна	lʲ i n a
скласці	s k ɫ a sʲ t͡sʲ i
прыгажун	p r ɨ ɣ a ʐ u n
перапампаваць	pʲ ɛ r a p a m p a v a t͡sʲ
гартоўны	ɣ a r t ɔ w n ɨ
празорца	p r a z ɔ r t͡s a
змяніць	zʲ mʲ a nʲ i t͡sʲ
пісьменнік	pʲ i sʲ mʲ ɛ nʲː i k
дасціпны	d a sʲ t͡sʲ i p n ɨ
ільнішча	i lʲ nʲ i ʂ t͡ʂ a
сцвердзіць	sʲ t͡sʲ vʲ ɛ r d͡zʲ i t͡sʲ
зачыніць	z a t͡ʂ ɨ nʲ i t͡sʲ
радзей	r a d͡zʲ ɛ j
свежына	sʲ vʲ ɛ ʐ ɨ n a
агледзіны	a ɣ lʲ ɛ d͡zʲ i n ɨ
валоскі	v a ɫ ɔ s kʲ i
кіпцік	kʲ i p t͡sʲ i k
высокакваліфікаваны	v ɨ s ɔ k a k v a lʲ i fʲ i k a v a n ɨ
заправадзіць	z a p r a v a d͡zʲ i t͡sʲ
нарадзіць	n a r a d͡zʲ i t͡sʲ
паблажлівы	p a b ɫ a ʐ lʲ i v ɨ
хітрыкі	xʲ i t r ɨ kʲ i
галіцца	ɣ a lʲ i t͡sː a
вялікаўзроставы	vʲ a lʲ i k a w z r ɔ s t a v ɨ
стаўбун	s t a w b u n
выскубці	v ɨ s k u b t͡sʲ i
зайздрослівы	z a j z d r ɔ sʲ lʲ i v ɨ
нахіліць	n a xʲ i lʲ i t͡sʲ
прадвызначыць	p r a d v ɨ z n a t͡ʂ ɨ t͡sʲ
цэтлік	t͡s ɛ t lʲ i k
змоўшчык	z m ɔ w ʂ t͡ʂ ɨ k
правы	p r a v ɨ
бабровіна	b a b r ɔ vʲ i n a
паназіраць	p a n a zʲ i r a t͡sʲ
конаўка	k ɔ n a w k a
бітон	bʲ i t ɔ n
рассвідраваць	r a sʲː vʲ i d r a v a t͡sʲ
падрабіць	p a d r a bʲ i t͡sʲ
усутыч	u s u t ɨ t͡ʂ
смага	s m a ɣ a
заблакітнець	z a b ɫ a kʲ i t nʲ ɛ t͡sʲ
люцэрнішча	lʲ u t͡s ɛ r nʲ i ʂ t͡ʂ a
выдатнік	v ɨ d a t nʲ i k
пераймальны	pʲ ɛ r a j m a lʲ n ɨ
уявіць	u j a vʲ i t͡sʲ
сноўдацца	s n ɔ w d a t͡sː a
нашкодзіць	n a ʂ k ɔ d͡zʲ i t͡sʲ
самаўпраўнасць	s a m a w p r a w n a sʲ t͡sʲ
награвальнік	n a ɣ r a v a lʲ nʲ i k
двухсхільны	d v u x s xʲ i lʲ n ɨ
папярэднік	p a pʲ a r ɛ d nʲ i k
устурбаваць	u s t u r b a v a t͡sʲ
чапяла	t͡ʂ a pʲ a ɫ a
замаркоціцца	z a m a r k ɔ t͡sʲ i t͡sː a
самаакупнасць	s a m a a k u p n a sʲ t͡sʲ
мяжоўка	mʲ a ʐ ɔ w k a
выжлукціць	v ɨ ʐ ɫ u k t͡sʲ i t͡sʲ
паблакітнець	p a b ɫ a kʲ i t nʲ ɛ t͡sʲ
штогоднік	ʂ t ɔ ɣ ɔ d nʲ i k
умоўны	u m ɔ w n ɨ
лістападобны	lʲ i s t a p a d ɔ b n ɨ
шпіталізаваць	ʂ pʲ i t a lʲ i z a v a t͡sʲ
клапаціцца	k ɫ a p a t͡sʲ i t͡sː a
гаіць	ɣ a j i t͡sʲ
высокакаштоўны	v ɨ s ɔ k a k a ʂ t ɔ w n ɨ
шолах	ʂ ɔ ɫ a x
прыдбаць	p r ɨ d b a t͡sʲ
суправаджальнік	s u p r a v a d ʐ a lʲ nʲ i k
падстраўнікавы	p a d s t r a w nʲ i k a v ɨ
падзіравіць	p a d͡zʲ i r a vʲ i t͡sʲ
могілкі	m ɔ ɣʲ i ɫ kʲ i
дойлідства	d ɔ j lʲ i d s t v a
удасканаліць	u d a s k a n a lʲ i t͡sʲ
напэўна	n a p ɛ w n a
цыбаты	t͡s ɨ b a t ɨ
пыласос	p ɨ ɫ a s ɔ s
самаўдасканальвацца	s a m a w d a s k a n a lʲ v a t͡sː a
аселіца	a sʲ ɛ lʲ i t͡s a
церануць	t͡sʲ ɛ r a n u t͡sʲ
адноўнік	a d n ɔ w nʲ i k
вяндліна	vʲ a n d lʲ i n a
ралля	r a lʲ lʲ ʲ a
кіначасопіс	kʲ i n a t͡ʂ a s ɔ pʲ i s
завэндзіць	z a v ɛ n d͡zʲ i t͡sʲ
самаўзбагачэнне	s a m a w z b a ɣ a t͡ʂ ɛ nʲː ɛ
паслядоўны	p a sʲ lʲ a d ɔ w n ɨ
знайсці	z n a j sʲ t͡sʲ i
плёскат	p lʲ ɔ s k a t
узаемаўплыў	u z a j ɛ m a w p ɫ ɨ w
пажыўны	p a ʐ ɨ w n ɨ
павыдаткоўваць	p a v ɨ d a t k ɔ w v a t͡sʲ
жорсткі	ʐ ɔ r s t kʲ i
адухаўленне	a d u x a w lʲ ɛ nʲː ɛ
вазацкі	v a z a t͡s kʲ i
дапасвіць	d a p a sʲ vʲ i t͡sʲ
пасол	p a s ɔ ɫ
прызвычаіцца	p r ɨ z v ɨ t͡ʂ a j i t͡sː a
спруцянець	s p r u t͡sʲ a nʲ ɛ t͡sʲ
самазагаранне	s a m a z a ɣ a r a nʲː ɛ
лапцюжнік	ɫ a p t͡sʲ u ʐ nʲ i k
паздзімаць	p a z d͡zʲ i m a t͡sʲ
землеўласнік	zʲ ɛ m lʲ ɛ w ɫ a sʲ nʲ i k
вэндзіць	v ɛ n d͡zʲ i t͡sʲ
сутыкнуць	s u t ɨ k n u t͡sʲ
кілзаць	kʲ i ɫ z a t͡sʲ
пападкрэсліваць	p a p a d k r ɛ sʲ lʲ i v a t͡sʲ
моўчкі	m ɔ w t͡ʂ kʲ i
парасчыняць	p a r a s t͡ʂ ɨ nʲ a t͡sʲ
красамоўнасць	k r a s a m ɔ w n a sʲ t͡sʲ
росчын	r ɔ s t͡ʂ ɨ n
паўапрануты	p a w a p r a n u t ɨ
перахварэць	pʲ ɛ r a x v a r ɛ t͡sʲ
сасцёбаць	s a sʲ t͡sʲ ɔ b a t͡sʲ
угрунтаваць	u ɣ r u n t a v a t͡sʲ
цесля	t͡sʲ ɛ sʲ lʲ a
чынш	t͡ʂ ɨ n ʂ
шасціпавярховы	ʂ a sʲ t͡sʲ i p a vʲ a r x ɔ v ɨ
рухавік	r u x a vʲ i k
прыхільнасць	p r ɨ xʲ i lʲ n a sʲ t͡sʲ
уночы	u n ɔ t͡ʂ ɨ
паліца	p a lʲ i t͡s a
прамітусіцца	p r a mʲ i t u sʲ i t͡sː a
прычэплівы	p r ɨ t͡ʂ ɛ p lʲ i v ɨ
улегчы	u lʲ ɛ ɣ t͡ʂ ɨ
чапурысты	t͡ʂ a p u r ɨ s t ɨ
расхвастаць	r a s x v a s t a t͡sʲ
падтуліць	p a d t u lʲ i t͡sʲ
згубіцель	z ɣ u bʲ i t͡sʲ ɛ lʲ
звольніць	z v ɔ lʲ nʲ i t͡sʲ
завіруха	z a vʲ i r u x a
харчаванне	x a r t͡ʂ a v a nʲː ɛ
пытацца	p ɨ t a t͡sː a
перачакаць	pʲ ɛ r a t͡ʂ a k a t͡sʲ
плуг	p ɫ u ɣ
стрэльба	s t r ɛ lʲ b a
храпка	x r a p k a
аб’інець	a b ’ʲ i nʲ ɛ t͡sʲ
мітусня	mʲ i t u sʲ nʲ a
маркоціцца	m a r k ɔ t͡sʲ i t͡sː a
рыбаахова	r ɨ b a a x ɔ v a
сыравіна	s ɨ r a vʲ i n a
водбліск	v ɔ d b lʲ i s k
плывушка	p ɫ ɨ v u ʂ k a
аскрэбці	a s k r ɛ b t͡sʲ i
пераўтваральнік	pʲ ɛ r a w t v a r a lʲ nʲ i k
селянін	sʲ ɛ lʲ a nʲ i n
цеплаёмісты	t͡sʲ ɛ p ɫ a j ɔ mʲ i s t ɨ
пападсоўваць	p a p a d s ɔ w v a t͡sʲ
паціснуць	p a t͡sʲ i s n u t͡sʲ
пасмуткаваць	p a s m u t k a v a t͡sʲ
пытальнік	p ɨ t a lʲ nʲ i k
камяніца	k a mʲ a nʲ i t͡s a
улегцы	u lʲ ɛ ɣ t͡s ɨ
шчымлівы	ʂ t͡ʂ ɨ m lʲ i v ɨ
бурачнік	b u r a t͡ʂ nʲ i k
прымаляваць	p r ɨ m a lʲ a v a t͡sʲ
шалупайка	ʂ a ɫ u p a j k a
радыёаматар	r a d ɨ j ɔ a m a t a r
аблазіць	a b ɫ a zʲ i t͡sʲ
цёмна-гняды	t͡sʲ ɔ m n a ɣ nʲ a d ɨ
богазневажальнік	b ɔ ɣ a zʲ nʲ ɛ v a ʐ a lʲ nʲ i k
управа	u p r a v a
прыхаваць	p r ɨ x a v a t͡sʲ
перавырашыць	pʲ ɛ r a v ɨ r a ʂ ɨ t͡sʲ
міжгатунковы	mʲ i ʐ ɣ a t u n k ɔ v ɨ
макавішча	m a k a vʲ i ʂ t͡ʂ a
расфарбоўка	r a s f a r b ɔ w k a
маляўнічы	m a lʲ a w nʲ i t͡ʂ ɨ
прыпхнуць	p r ɨ p x n u t͡sʲ
даўжэць	d a w ʐ ɛ t͡sʲ
дубальтоўка	d u b a lʲ t ɔ w k a
умоўчаць	u m ɔ w t͡ʂ a t͡sʲ
светнік	sʲ vʲ ɛ t nʲ i k
уздзіраць	u z d͡zʲ i r a t͡sʲ
партрэт	p a r t r ɛ t
хуткі	x u t kʲ i
клічнік	k lʲ i t͡ʂ nʲ i k
міжсценне	mʲ i ʐ sʲ t͡sʲ ɛ nʲː ɛ
тыцнуць	t ɨ t͡s n u t͡sʲ
атуліць	a t u lʲ i t͡sʲ
разважыць	r a z v a ʐ ɨ t͡sʲ
натхніцель	n a t x nʲ i t͡sʲ ɛ lʲ
блытаніна	b ɫ ɨ t a nʲ i n a
пісклівы	pʲ i s k lʲ i v ɨ
прывілеяваны	p r ɨ vʲ i lʲ ɛ j a v a n ɨ
безгрунтоўны	bʲ ɛ z ɣ r u n t ɔ w n ɨ
гайнік	ɣ a j nʲ i k
залысіць	z a ɫ ɨ sʲ i t͡sʲ
прачытаць	p r a t͡ʂ ɨ t a t͡sʲ
парасцярушваць	p a r a sʲ t͡sʲ a r u ʂ v a t͡sʲ
скокі	s k ɔ kʲ i
вёрткі	vʲ ɔ r t kʲ i
збродлівы	z b r ɔ d lʲ i v ɨ
асучасніць	a s u t͡ʂ a sʲ nʲ i t͡sʲ
пастух	p a s t u x
самакіравальны	s a m a kʲ i r a v a lʲ n ɨ
гуллівы	ɣ u lʲ lʲ ʲ i v ɨ
супярэчлівы	s u pʲ a r ɛ t͡ʂ lʲ i v ɨ
прамарудзіць	p r a m a r u d͡zʲ i t͡sʲ
гідлівы	ɣʲ i d lʲ i v ɨ
прыробак	p r ɨ r ɔ b a k
заспакоіць	z a s p a k ɔ j i t͡sʲ
занудзіцца	z a n u d͡zʲ i t͡sː a
маўленчы	m a w lʲ ɛ n t͡ʂ ɨ
перадрукаваць	pʲ ɛ r a d r u k a v a t͡sʲ
выслізнуць	v ɨ sʲ lʲ i z n u t͡sʲ
перапытаць	pʲ ɛ r a p ɨ t a t͡sʲ
ранкам	r a n k a m
папэцкаць	p a p ɛ t͡s k a t͡sʲ
вірыць	vʲ i r ɨ t͡sʲ
здзейсніць	z d͡zʲ ɛ j sʲ nʲ i t͡sʲ
чапурыцца	t͡ʂ a p u r ɨ t͡sː a
узаемапавага	u z a j ɛ m a p a v a ɣ a
карыслівец	k a r ɨ sʲ lʲ i vʲ ɛ t͡s
прадаўжальнік	p r a d a w ʐ a lʲ nʲ i k
падоўжыць	p a d ɔ w ʐ ɨ t͡sʲ
раён	r a j ɔ n
шаленец	ʂ a lʲ ɛ nʲ ɛ t͡s
бензасховішча	bʲ ɛ n z a s x ɔ vʲ i ʂ t͡ʂ a
няўхільны	nʲ a w xʲ i lʲ n ɨ
тнуць	t n u t͡sʲ
ільсніцца	i lʲ sʲ nʲ i t͡sː a
першакрыніца	pʲ ɛ r ʂ a k r ɨ nʲ i t͡s a
летуценнік	lʲ ɛ t u t͡sʲ ɛ nʲː i k
вісельня	vʲ i sʲ ɛ lʲ nʲ a
жаліцца	ʐ a lʲ i t͡sː a
паманіць	p a m a nʲ i t͡sʲ
пралайдачыць	p r a ɫ a j d a t͡ʂ ɨ t͡sʲ
адведзіны	a d vʲ ɛ d͡zʲ i n ɨ
прадзяўбці	p r a d͡zʲ a w b t͡sʲ i
заклапаціць	z a k ɫ a p a t͡sʲ i t͡sʲ
перагарнуць	pʲ ɛ r a ɣ a r n u t͡sʲ
гаваркі	ɣ a v a r kʲ i
споведзь	s p ɔ vʲ ɛ d zʲ
узаемаразлікі	u z a j ɛ m a r a zʲ lʲ i kʲ i
ляшчэўнік	lʲ a ʂ t͡ʂ ɛ w nʲ i k
сунічнік	s u nʲ i t͡ʂ nʲ i k
хвораст	x v ɔ r a s t
уласкавіць	u ɫ a s k a vʲ i t͡sʲ
узровень	u z r ɔ vʲ ɛ nʲ
прытарнаваць	p r ɨ t a r n a v a t͡sʲ
прамысловы	p r a m ɨ s ɫ ɔ v ɨ
задышлівы	z a d ɨ ʂ lʲ i v ɨ
зноўку	z n ɔ w k u
прашараваць	p r a ʂ a r a v a t͡sʲ
аблавухі	a b ɫ a v u xʲ i
пазногаць	p a z n ɔ ɣ a t͡sʲ
прасоваць	p r a s ɔ v a t͡sʲ
подбегам	p ɔ d bʲ ɛ ɣ a m
даладзіць	d a ɫ a d͡zʲ i t͡sʲ
спрадаць	s p r a d a t͡sʲ
укормлены	u k ɔ r m lʲ ɛ n ɨ
увесь	u vʲ ɛ sʲ
цікаваць	t͡sʲ i k a v a t͡sʲ
целяпацца	t͡sʲ ɛ lʲ a p a t͡sː a
выканаўчы	v ɨ k a n a w t͡ʂ ɨ
паляпшаць	p a lʲ a p ʂ a t͡sʲ
адвабіць	a d v a bʲ i t͡sʲ
мімавольны	mʲ i m a v ɔ lʲ n ɨ
стромкі	s t r ɔ m kʲ i
прамежак	p r a mʲ ɛ ʐ a k
крыўдзіцель	k r ɨ w d͡zʲ i t͡sʲ ɛ lʲ
прыгледзецца	p r ɨ ɣ lʲ ɛ d͡zʲ ɛ t͡sː a
ахінуць	a xʲ i n u t͡sʲ
малапісьменны	m a ɫ a pʲ i sʲ mʲ ɛ nː ɨ
абяссэнсіць	a bʲ a s s ɛ n sʲ i t͡sʲ
водапранікальны	v ɔ d a p r a nʲ i k a lʲ n ɨ
радасць	r a d a sʲ t͡sʲ
кнігазнаўства	k nʲ i ɣ a z n a w s t v a
зманіць	z m a nʲ i t͡sʲ
прыдрукоўка	p r ɨ d r u k ɔ w k a
знясіліць	zʲ nʲ a sʲ i lʲ i t͡sʲ
пераважыць	pʲ ɛ r a v a ʐ ɨ t͡sʲ
схаднейшы	s x a d nʲ ɛ j ʂ ɨ
дапытлівасць	d a p ɨ t lʲ i v a sʲ t͡sʲ
пацэліць	p a t͡s ɛ lʲ i t͡sʲ
удава	u d a v a
адпаведнік	a d p a vʲ ɛ d nʲ i k
узбегчы	u zʲ bʲ ɛ ɣ t͡ʂ ɨ
імклівы	i m k lʲ i v ɨ
кілім	kʲ i lʲ i m
здзяцінець	z d͡zʲ a t͡sʲ i nʲ ɛ t͡sʲ
хібнасць	xʲ i b n a sʲ t͡sʲ
рознастароннасць	r ɔ z n a s t a r ɔ nː a sʲ t͡sʲ
скамянець	s k a mʲ a nʲ ɛ t͡sʲ
саманадзейны	s a m a n a d͡zʲ ɛ j n ɨ
шалпацець	ʂ a ɫ p a t͡sʲ ɛ t͡sʲ
зубніца	z u b nʲ i t͡s a
уцёкі	u t͡sʲ ɔ kʲ i
ушпіліць	u ʂ pʲ i lʲ i t͡sʲ
перасмажыць	pʲ ɛ r a s m a ʐ ɨ t͡sʲ
потарч	p ɔ t a r t͡ʂ
кара	k a r a
усмаліць	u s m a lʲ i t͡sʲ
замалёўка	z a m a lʲ ɔ w k a
самаадмаўленне	s a m a a d m a w lʲ ɛ nʲː ɛ
рад	r a d
пракаўтнуць	p r a k a w t n u t͡sʲ
ён	j ɔ n
цаца	t͡s a t͡s a
узбадзёрыць	u z b a d͡zʲ ɔ r ɨ t͡sʲ
іншасказальны	i n ʂ a s k a z a lʲ n ɨ
выпасвіць	v ɨ p a sʲ vʲ i t͡sʲ
кругавід	k r u ɣ a vʲ i d
ператруціць	pʲ ɛ r a t r u t͡sʲ i t͡sʲ
сухарлявы	s u x a r lʲ a v ɨ
канапліна	k a n a p lʲ i n a
ліхаманка	lʲ i x a m a n k a
роспач	r ɔ s p a t͡ʂ
правартаваць	p r a v a r t a v a t͡sʲ
скразняк	s k r a zʲ nʲ a k
чысцік	t͡ʂ ɨ sʲ t͡sʲ i k
проза	p r ɔ z a
засцярожлівы	z a sʲ t͡sʲ a r ɔ ʐ lʲ i v ɨ
жоўцевы	ʐ ɔ w t͡sʲ ɛ v ɨ
надліць	n a d lʲ i t͡sʲ
шалі	ʂ a lʲ i
скурчыць	s k u r t͡ʂ ɨ t͡sʲ
патужэць	p a t u ʐ ɛ t͡sʲ
мізарнець	mʲ i z a r nʲ ɛ t͡sʲ
дзівацтва	d͡zʲ i v a t͡s t v a
улюбенец	u lʲ u bʲ ɛ nʲ ɛ t͡s
збавіцель	z b a vʲ i t͡sʲ ɛ lʲ
паімжэць	p a j i m ʐ ɛ t͡sʲ
распаліць	r a s p a lʲ i t͡sʲ
свабодамысны	s v a b ɔ d a m ɨ s n ɨ
трохвугольнік	t r ɔ x v u ɣ ɔ lʲ nʲ i k
спажытак	s p a ʐ ɨ t a k
цвінтар	t͡sʲ vʲ i n t a r
сенасховішча	sʲ ɛ n a s x ɔ vʲ i ʂ t͡ʂ a
абястлусціць	a bʲ a s t ɫ u sʲ t͡sʲ i t͡sʲ
гібельны	ɣʲ i bʲ ɛ lʲ n ɨ
сцюжа	sʲ t͡sʲ u ʐ a
шчупак	ʂ t͡ʂ u p a k
павыціскаць	p a v ɨ t͡sʲ i s k a t͡sʲ
багаткі	b a ɣ a t kʲ i
карчэўе	k a r t͡ʂ ɛ w j ɛ
злітавацца	zʲ lʲ i t a v a t͡sː a
прымаўляць	p r ɨ m a w lʲ a t͡sʲ
скарбнік	s k a r b nʲ i k
квітнець	k vʲ i t nʲ ɛ t͡sʲ
сківіца	s kʲ i vʲ i t͡s a
мурашнік	m u r a ʂ nʲ i k
ступа	s t u p a
памажнець	p a m a ʐ nʲ ɛ t͡sʲ
сутычка	s u t ɨ t͡ʂ k a
важданіна	v a ʐ d a nʲ i n a
ператрымка	pʲ ɛ r a t r ɨ m k a
праблема	p r a b lʲ ɛ m a
перадрук	pʲ ɛ r a d r u k
халаднік	x a ɫ a d nʲ i k
параздзімаць	p a r a z d͡zʲ i m a t͡sʲ
шкарлупіна	ʂ k a r ɫ u pʲ i n a
ушчыкнуць	u ʂ t͡ʂ ɨ k n u t͡sʲ
скусаць	s k u s a t͡sʲ
паслухмяны	p a s ɫ u x mʲ a n ɨ
разлінеіць	r a zʲ lʲ i nʲ ɛ j i t͡sʲ
газоўка	ɣ a z ɔ w k a
уходзіны	u x ɔ d͡zʲ i n ɨ
падмуроўка	p a d m u r ɔ w k a
радасны	r a d a s n ɨ
прапытаць	p r a p ɨ t a t͡sʲ
спатрэбіцца	s p a t r ɛ bʲ i t͡sː a
заквітнець	z a k vʲ i t nʲ ɛ t͡sʲ
цемнаскуры	t͡sʲ ɛ m n a s k u r ɨ
штохвіліны	ʂ t ɔ x vʲ i lʲ i n ɨ
блакітны	b ɫ a kʲ i t n ɨ
гіпергук	ɣʲ i pʲ ɛ r ɣ u k
ёмішча	j ɔ mʲ i ʂ t͡ʂ a
перш	pʲ ɛ r ʂ
вытупіць	v ɨ t u pʲ i t͡sʲ
падлічыць	p a d lʲ i t͡ʂ ɨ t͡sʲ
самавыяўленне	s a m a v ɨ j a w lʲ ɛ nʲː ɛ
фотавідарыс	f ɔ t a vʲ i d a r ɨ s
супадзенне	s u p a d͡zʲ ɛ nʲː ɛ
летапіс	lʲ ɛ t a pʲ i s
мігцець	mʲ i ɣ t͡sʲ ɛ t͡sʲ
падвэндзіць	p a d v ɛ n d͡zʲ i t͡sʲ
сакавіты	s a k a vʲ i t ɨ
спарахнець	s p a r a x nʲ ɛ t͡sʲ
запінка	z a pʲ i n k a
адбітак	a d bʲ i t a k
заклік	z a k lʲ i k
дасеўкі	d a sʲ ɛ w kʲ i
сшытак	s ʂ ɨ t a k
кішэня	kʲ i ʂ ɛ nʲ a
пераразмеркаваць	pʲ ɛ r a r a zʲ mʲ ɛ r k a v a t͡sʲ
паспяховы	p a sʲ pʲ a x ɔ v ɨ
паацярэбліваць	p a a t͡sʲ a r ɛ b lʲ i v a t͡sʲ
пераднаціскны	pʲ ɛ r a d n a t͡sʲ i s k n ɨ
разгубіцца	r a z ɣ u bʲ i t͡sː a
напаўапрануты	n a p a w a p r a n u t ɨ
спалох	s p a ɫ ɔ x
заскрэбці	z a s k r ɛ b t͡sʲ i
ператлумачыць	pʲ ɛ r a t ɫ u m a t͡ʂ ɨ t͡sʲ
скрыўдзіць	s k r ɨ w d͡zʲ i t͡sʲ
пазафарбоўваць	p a z a f a r b ɔ w v a t͡sʲ
палівачка	p a lʲ i v a t͡ʂ k a
бязлітасны	bʲ a zʲ lʲ i t a s n ɨ
цвілы	t͡sʲ vʲ i ɫ ɨ
род	r ɔ d
радзімка	r a d͡zʲ i m k a
сітаваты	sʲ i t a v a t ɨ
раздзімаць	r a z d͡zʲ i m a t͡sʲ
разгарнуць	r a z ɣ a r n u t͡sʲ
саўдзел	s a w d͡zʲ ɛ ɫ
уціск	u t͡sʲ i s k
папрыбудоўваць	p a p r ɨ b u d ɔ w v a t͡sʲ
дзяўчынка	d͡zʲ a w t͡ʂ ɨ n k a
паўночнік	p a w n ɔ t͡ʂ nʲ i k
пагаіць	p a ɣ a j i t͡sʲ
пацікавіцца	p a t͡sʲ i k a vʲ i t͡sː a
ёдкі	j ɔ d kʲ i
здаўмецца	z d a w mʲ ɛ t͡sː a
менавіта	mʲ ɛ n a vʲ i t a
брамнік	b r a m nʲ i k
прыпляскаць	p r ɨ p lʲ a s k a t͡sʲ
рогат	r ɔ ɣ a t
наступнік	n a s t u p nʲ i k
пояс	p ɔ j a s
спахмурнець	s p a x m u r nʲ ɛ t͡sʲ
гэтакі	ɣ ɛ t a kʲ i
чатырохрадкоўе	t͡ʂ a t ɨ r ɔ x r a d k ɔ w j ɛ
прыхіліць	p r ɨ xʲ i lʲ i t͡sʲ
праказаць	p r a k a z a t͡sʲ
кляновік	k lʲ a n ɔ vʲ i k
безвыніковы	bʲ ɛ z v ɨ nʲ i k ɔ v ɨ
адлінуць	a d lʲ i n u t͡sʲ
рэчыўны	r ɛ t͡ʂ ɨ w n ɨ
накіраваць	n a kʲ i r a v a t͡sʲ
злоўжываць	z ɫ ɔ w ʐ ɨ v a t͡sʲ
падтрэсці	p a d t r ɛ sʲ t͡sʲ i
натоўп	n a t ɔ w p
скалка	s k a ɫ k a
паглынальнік	p a ɣ ɫ ɨ n a lʲ nʲ i k
хлус	x ɫ u s
шар	ʂ a r
радыёсувязь	r a d ɨ j ɔ s u vʲ a zʲ
забрудніць	z a b r u d nʲ i t͡sʲ
заклікаць	z a k lʲ i k a t͡sʲ
скрыва	s k r ɨ v a
стынь	s t ɨ nʲ
нацерабіць	n a t͡sʲ ɛ r a bʲ i t͡sʲ
існы	i s n ɨ
просты	p r ɔ s t ɨ
спячы	sʲ pʲ a t͡ʂ ɨ
безадмоўны	bʲ ɛ z a d m ɔ w n ɨ
ціхмяны	t͡sʲ i x mʲ a n ɨ
ходнік	x ɔ d nʲ i k
папярэджанне	p a pʲ a r ɛ d ʐ a nʲː ɛ
калатоўка	k a ɫ a t ɔ w k a
узбурыць	u z b u r ɨ t͡sʲ
парасхінаць	p a r a s xʲ i n a t͡sʲ
удакладніць	u d a k ɫ a d nʲ i t͡sʲ
саржавець	s a r ʐ a vʲ ɛ t͡sʲ
спакуслівы	s p a k u sʲ lʲ i v ɨ
упрыгожыць	u p r ɨ ɣ ɔ ʐ ɨ t͡sʲ
укачаць	u k a t͡ʂ a t͡sʲ
пераўвасобіць	pʲ ɛ r a w v a s ɔ bʲ i t͡sʲ
паведаміць	p a vʲ ɛ d a mʲ i t͡sʲ
палупцаваць	p a ɫ u p t͡s a v a t͡sʲ
будаўнік	b u d a w nʲ i k
запасіць	z a p a sʲ i t͡sʲ
знаравіць	z n a r a vʲ i t͡sʲ
ахмістрыня	a x mʲ i s t r ɨ nʲ a
пашкліць	p a ʂ k lʲ i t͡sʲ
падвабіць	p a d v a bʲ i t͡sʲ
дзяўбці	d͡zʲ a w b t͡sʲ i
злоўлены	z ɫ ɔ w lʲ ɛ n ɨ
рака	r a k a
праглынуць	p r a ɣ ɫ ɨ n u t͡sʲ
ліснік	lʲ i sʲ nʲ i k
знішчальнік	zʲ nʲ i ʂ t͡ʂ a lʲ nʲ i k
размацаваць	r a z m a t͡s a v a t͡sʲ
праскародзіць	p r a s k a r ɔ d͡zʲ i t͡sʲ
паздыхаць	p a z d ɨ x a t͡sʲ
памуляць	p a m u lʲ a t͡sʲ
разборлівы	r a z b ɔ r lʲ i v ɨ
пара	p a r a
галінасты	ɣ a lʲ i n a s t ɨ
шапаткі	ʂ a p a t kʲ i
часцяком	t͡ʂ a sʲ t͡sʲ a k ɔ m
намеснік	n a mʲ ɛ sʲ nʲ i k
напаўадчынены	n a p a w a t͡ʂː ɨ nʲ ɛ n ɨ
топкі	t ɔ p kʲ i
спачатку	s p a t͡ʂ a t k u
таран	t a r a n
пісьменны	pʲ i sʲ mʲ ɛ nː ɨ
дзеяслоў	d͡zʲ ɛ j a s ɫ ɔ w
дрэўны	d r ɛ w n ɨ
комін	k ɔ mʲ i n
індык	i n d ɨ k
адвесці	a d vʲ ɛ sʲ t͡sʲ i
падваліна	p a d v a lʲ i n a
шаргануць	ʂ a r ɣ a n u t͡sʲ
паўжабрацкі	p a w ʐ a b r a t͡s kʲ i
перашуфляваць	pʲ ɛ r a ʂ u f lʲ a v a t͡sʲ
растэрміноўка	r a s t ɛ r mʲ i n ɔ w k a
паселішча	p a sʲ ɛ lʲ i ʂ t͡ʂ a
развярнуць	r a zʲ vʲ a r n u t͡sʲ
трыножка	t r ɨ n ɔ ʐ k a
мышалоў	m ɨ ʂ a ɫ ɔ w
хаўтуры	x a w t u r ɨ
апоўзень	a p ɔ w zʲ ɛ nʲ
купіна	k u pʲ i n a
выграбці	v ɨ ɣ r a b t͡sʲ i
заняткі	z a nʲ a t kʲ i
патыліца	p a t ɨ lʲ i t͡s a
дзічка	d͡zʲ i t͡ʂ k a
крыўдзіць	k r ɨ w d͡zʲ i t͡sʲ
зацірка	z a t͡sʲ i r k a
драбнатраўе	d r a b n a t r a w j ɛ
выродлівы	v ɨ r ɔ d lʲ i v ɨ
дылёўка	d ɨ lʲ ɔ w k a
начаўпці	n a t͡ʂ a w p t͡sʲ i
перашкодзіць	pʲ ɛ r a ʂ k ɔ d͡zʲ i t͡sʲ
гадзіншчык	ɣ a d͡zʲ i n ʂ t͡ʂ ɨ k
савучань	s a v u t͡ʂ a nʲ
трохцалёўка	t r ɔ x t͡s a lʲ ɔ w k a
спарыш	s p a r ɨ ʂ
разлегласць	r a zʲ lʲ ɛ ɣ ɫ a sʲ t͡sʲ
дрыжнік	d r ɨ ʐ nʲ i k
уздоўж	u z d ɔ w ʐ
угары	u ɣ a r ɨ
падсівіць	p a d sʲ i vʲ i t͡sʲ
сашчапіць	s a ʂ t͡ʂ a pʲ i t͡sʲ
віднець	vʲ i d nʲ ɛ t͡sʲ
кірпаты	kʲ i r p a t ɨ
калатніна	k a ɫ a t nʲ i n a
вокліч	v ɔ k lʲ i t͡ʂ
страта	s t r a t a
запляміць	z a p lʲ a mʲ i t͡sʲ
каліва	k a lʲ i v a
ускаламуціць	u s k a ɫ a m u t͡sʲ i t͡sʲ
паха	p a x a
мроі	m r ɔ j i
памардаваць	p a m a r d a v a t͡sʲ
ушчыльняльнік	u ʂ t͡ʂ ɨ lʲ nʲ a lʲ nʲ i k
абмоўка	a b m ɔ w k a
рана	r a n a
паўрадкоўе	p a w r a d k ɔ w j ɛ
паклёпнічаць	p a k lʲ ɔ p nʲ i t͡ʂ a t͡sʲ
позірк	p ɔ zʲ i r k
страхоцце	s t r a x ɔ t͡sʲː ɛ
заканадаўства	z a k a n a d a w s t v a
сход	s x ɔ d
ваўкалак	v a w k a ɫ a k
адкруціць	a d k r u t͡sʲ i t͡sʲ
карпаніна	k a r p a nʲ i n a
сёе-тое	sʲ ɔ j ɛ - t ɔ j ɛ
завідна	z a vʲ i d n a
падмянціць	p a d mʲ a n t͡sʲ i t͡sʲ
валаводзіцца	v a ɫ a v ɔ d͡zʲ i t͡sː a
скупы	s k u p ɨ
замовіць	z a m ɔ vʲ i t͡sʲ
трунак	t r u n a k
адскародзіць	a d s k a r ɔ d͡zʲ i t͡sʲ
рознагалоссе	r ɔ z n a ɣ a ɫ ɔ sʲː ɛ
забруіць	z a b r u j i t͡sʲ
апраменіць	a p r a mʲ ɛ nʲ i t͡sʲ
сцвярдзець	sʲ t͡sʲ vʲ a r d͡zʲ ɛ t͡sʲ
прышчапіць	p r ɨ ʂ t͡ʂ a pʲ i t͡sʲ
даходлівы	d a x ɔ d lʲ i v ɨ
аднавокі	a d n a v ɔ kʲ i
выгіб	v ɨ ɣʲ i b
узліць	u zʲ lʲ i t͡sʲ
дадрукоўка	d a d r u k ɔ w k a
раскілзаць	r a s kʲ i ɫ z a t͡sʲ
каратканосік	k a r a t k a n ɔ sʲ i k
параіць	p a r a j i t͡sʲ
даўней	d a w nʲ ɛ j
сабакарня	s a b a k a r nʲ a
жытнішча	ʐ ɨ t nʲ i ʂ t͡ʂ a
забавіць	z a b a vʲ i t͡sʲ
занадзіць	z a n a d͡zʲ i t͡sʲ
угрунь	u ɣ r u nʲ
падсмаліць	p a d s m a lʲ i t͡sʲ
тлуміць	t ɫ u mʲ i t͡sʲ
відазменлівы	vʲ i d a zʲ mʲ ɛ n lʲ i v ɨ
бавоўнік	b a v ɔ w nʲ i k
патрызніць	p a t r ɨ zʲ nʲ i t͡sʲ
завельмі	z a vʲ ɛ lʲ mʲ i
папрысутнічаць	p a p r ɨ s u t nʲ i t͡ʂ a t͡sʲ
шапатлівы	ʂ a p a t lʲ i v ɨ
мядзведзіна	mʲ a d͡zʲ vʲ ɛ d͡zʲ i n a
уплюхаць	u p lʲ u x a t͡sʲ
слодыч	s ɫ ɔ d ɨ t͡ʂ
хаўрусаваць	x a w r u s a v a t͡sʲ
парушаць	p a r u ʂ a t͡sʲ
кінастужка	kʲ i n a s t u ʐ k a
заспакойлівы	z a s p a k ɔ j lʲ i v ɨ
ілжэсведчанне	i ɫ ʐ ɛ sʲ vʲ ɛ t͡ʂː a nʲː ɛ
паціскаць	p a t͡sʲ i s k a t͡sʲ
крыўдны	k r ɨ w d n ɨ
разлік	r a zʲ lʲ i k
паслядоўнік	p a sʲ lʲ a d ɔ w nʲ i k
прыжмурыць	p r ɨ ʐ m u r ɨ t͡sʲ
віск	vʲ i s k
сурдук	s u r d u k
сатлець	s a t lʲ ɛ t͡sʲ
плынь	p ɫ ɨ nʲ
паахінаць	p a a xʲ i n a t͡sʲ
спотайку	s p ɔ t a j k u
мінулае	mʲ i n u ɫ a j ɛ
гінуць	ɣʲ i n u t͡sʲ
выцепліць	v ɨ t͡sʲ ɛ p lʲ i t͡sʲ
лушпіна	ɫ u ʂ pʲ i n a
ржышча	r ʐ ɨ ʂ t͡ʂ a
сакавік	s a k a vʲ i k
дагладзіць	d a ɣ ɫ a d͡zʲ i t͡sʲ
падскубці	p a d s k u b t͡sʲ i
колеразнаўства	k ɔ lʲ ɛ r a z n a w s t v a
яндоўка	j a n d ɔ w k a
правазнавец	p r a v a z n a vʲ ɛ t͡s
унурыць	u n u r ɨ t͡sʲ
перадзяўбаць	pʲ ɛ r a d͡zʲ a w b a t͡sʲ
падзейнічаць	p a d͡zʲ ɛ j nʲ i t͡ʂ a t͡sʲ
байкапісец	b a j k a pʲ i sʲ ɛ t͡s
пажоўкнуць	p a ʐ ɔ w k n u t͡sʲ
ліхаманкавы	lʲ i x a m a n k a v ɨ
расчуліць	r a s t͡ʂ u lʲ i t͡sʲ
працавіты	p r a t͡s a vʲ i t ɨ
абрахманіць	a b r a x m a nʲ i t͡sʲ
перакрэсліць	pʲ ɛ r a k r ɛ sʲ lʲ i t͡sʲ
траціна	t r a t͡sʲ i n a
расліна	r a sʲ lʲ i n a
прамовіць	p r a m ɔ vʲ i t͡sʲ
радыё	r a d ɨ j ɔ
пераборлівы	pʲ ɛ r a b ɔ r lʲ i v ɨ
памітусіцца	p a mʲ i t u sʲ i t͡sː a
узмужнець	u z m u ʐ nʲ ɛ t͡sʲ
хадайнік	x a d a j nʲ i k
заплысці	z a p ɫ ɨ sʲ t͡sʲ i
разявіць	r a zʲ a vʲ i t͡sʲ
сербануць	sʲ ɛ r b a n u t͡sʲ
пачцівасць	p a t͡ʂ t͡sʲ i v a sʲ t͡sʲ
заўзяты	z a w zʲ a t ɨ
замыкальнік	z a m ɨ k a lʲ nʲ i k
прараўці	p r a r a w t͡sʲ i
бліскацець	b lʲ i s k a t͡sʲ ɛ t͡sʲ
сяўба	sʲ a w b a
садзьмуць	s a d zʲ m u t͡sʲ
пацешлівы	p a t͡sʲ ɛ ʂ lʲ i v ɨ
сходы	s x ɔ d ɨ
заціснуць	z a t͡sʲ i s n u t͡sʲ
пралодырнічаць	p r a ɫ ɔ d ɨ r nʲ i t͡ʂ a t͡sʲ
гасцінны	ɣ a sʲ t͡sʲ i nː ɨ
разлітавацца	r a zʲ lʲ i t a v a t͡sː a
купальнік	k u p a lʲ nʲ i k
усёабдымны	u sʲ ɔ a b d ɨ m n ɨ
оперупаўнаважаны	ɔ pʲ ɛ r u p a w n a v a ʐ a n ɨ
абезнадзеіць	a bʲ ɛ z n a d͡zʲ ɛ j i t͡sʲ
вышэйпералічаны	v ɨ ʂ ɛ j pʲ ɛ r a lʲ i t͡ʂ a n ɨ
умуроўка	u m u r ɔ w k a
прабразгаць	p r a b r a z ɣ a t͡sʲ
надзяўбці	n a d͡zʲ a w b t͡sʲ i
пагатоў	p a ɣ a t ɔ w
цнота	t͡s n ɔ t a
парэчнік	p a r ɛ t͡ʂ nʲ i k
зняволіць	zʲ nʲ a v ɔ lʲ i t͡sʲ
побыт	p ɔ b ɨ t
апавядальнік	a p a vʲ a d a lʲ nʲ i k
падгалоўе	p a d ɣ a ɫ ɔ w j ɛ
скок	s k ɔ k
перападлік	pʲ ɛ r a p a d lʲ i k
угару	u ɣ a r u
упароць	u p a r ɔ t͡sʲ
суайчыннік	s u a j t͡ʂ ɨ nʲː i k
саступіць	s a s t u pʲ i t͡sʲ
скалець	s k a lʲ ɛ t͡sʲ
ускалмаціць	u s k a ɫ m a t͡sʲ i t͡sʲ
старана	s t a r a n a
шчыры	ʂ t͡ʂ ɨ r ɨ
выпаўзень	v ɨ p a w zʲ ɛ nʲ
усклікнуць	u s k lʲ i k n u t͡sʲ
салавей	s a ɫ a vʲ ɛ j
прысоўваць	p r ɨ s ɔ w v a t͡sʲ
коснаязыкі	k ɔ s n a j a z ɨ kʲ i
уварваць	u v a r v a t͡sʲ
зарніца	z a r nʲ i t͡s a
мільгацець	mʲ i lʲ ɣ a t͡sʲ ɛ t͡sʲ
домабудаўнік	d ɔ m a b u d a w nʲ i k
вырабіць	v ɨ r a bʲ i t͡sʲ
перагледзець	pʲ ɛ r a ɣ lʲ ɛ d͡zʲ ɛ t͡sʲ
адтэрмінаваць	a d t ɛ r mʲ i n a v a t͡sʲ
выпукліць	v ɨ p u k lʲ i t͡sʲ
калі	k a lʲ i
прабавіць	p r a b a vʲ i t͡sʲ
дзедзіч	d͡zʲ ɛ d͡zʲ i t͡ʂ
захістаць	z a xʲ i s t a t͡sʲ
назіркам	n a zʲ i r k a m
раздражніць	r a z d r a ʐ nʲ i t͡sʲ
прадбачлівы	p r a d b a t͡ʂ lʲ i v ɨ
ацяпліць	a t͡sʲ a p lʲ i t͡sʲ
самаразлік	s a m a r a zʲ lʲ i k
таўчонік	t a w t͡ʂ ɔ nʲ i k
пакудлаціць	p a k u d ɫ a t͡sʲ i t͡sʲ
шклянка	ʂ k lʲ a n k a
запаволіць	z a p a v ɔ lʲ i t͡sʲ
дзейнічаць	d͡zʲ ɛ j nʲ i t͡ʂ a t͡sʲ
шкадаваць	ʂ k a d a v a t͡sʲ
збоўтаць	z b ɔ w t a t͡sʲ
шапка	ʂ a p k a
спакаваць	s p a k a v a t͡sʲ
выперадзіць	v ɨ pʲ ɛ r a d͡zʲ i t͡sʲ
полка	p ɔ ɫ k a
добраахвотнік	d ɔ b r a a x v ɔ t nʲ i k
выспеліць	v ɨ sʲ pʲ ɛ lʲ i t͡sʲ
крыжавіна	k r ɨ ʐ a vʲ i n a
беларусазнаўства	bʲ ɛ ɫ a r u s a z n a w s t v a
пратрываць	p r a t r ɨ v a t͡sʲ
пераплысці	pʲ ɛ r a p ɫ ɨ sʲ t͡sʲ i
угарнуць	u ɣ a r n u t͡sʲ
прылашчыць	p r ɨ ɫ a ʂ t͡ʂ ɨ t͡sʲ
немаўля	nʲ ɛ m a w lʲ a
незлічоны	nʲ ɛ zʲ lʲ i t͡ʂ ɔ n ɨ
пераўвільгатніць	pʲ ɛ r a w vʲ i lʲ ɣ a t nʲ i t͡sʲ
спачыць	s p a t͡ʂ ɨ t͡sʲ
хор	x ɔ r
паўсыравіна	p a w s ɨ r a vʲ i n a
ужыванне	u ʐ ɨ v a nʲː ɛ
слота	s ɫ ɔ t a
прываротнік	p r ɨ v a r ɔ t nʲ i k
пачэзнуць	p a t͡ʂ ɛ z n u t͡sʲ
павыгадоўваць	p a v ɨ ɣ a d ɔ w v a t͡sʲ
вісклівы	vʲ i s k lʲ i v ɨ
пяро	pʲ a r ɔ
хмарнасць	x m a r n a sʲ t͡sʲ
густоўны	ɣ u s t ɔ w n ɨ
паабшалёўваць	p a a b ʂ a lʲ ɔ w v a t͡sʲ
ахоўнік	a x ɔ w nʲ i k
выдасканаліць	v ɨ d a s k a n a lʲ i t͡sʲ
кіраўнічы	kʲ i r a w nʲ i t͡ʂ ɨ
трызніць	t r ɨ zʲ nʲ i t͡sʲ
звышціск	z v ɨ ʂ t͡sʲ i s k
папаліць	p a p a lʲ i t͡sʲ
цырк	t͡s ɨ r k
перакарабаціцца	pʲ ɛ r a k a r a b a t͡sʲ i t͡sː a
спадчыннік	s p a t͡ʂː ɨ nʲː i k
спрэчка	s p r ɛ t͡ʂ k a
балацянік	b a ɫ a t͡sʲ a nʲ i k
крынічышча	k r ɨ nʲ i t͡ʂ ɨ ʂ t͡ʂ a
іспытваць	i s p ɨ t v a t͡sʲ
растэрмінаваць	r a s t ɛ r mʲ i n a v a t͡sʲ
задзірлівы	z a d͡zʲ i r lʲ i v ɨ
расіца	r a sʲ i t͡s a
прахалода	p r a x a ɫ ɔ d a
правандраваць	p r a v a n d r a v a t͡sʲ
рашэцісты	r a ʂ ɛ t͡sʲ i s t ɨ
калітка	k a lʲ i t k a
усмажыць	u s m a ʐ ɨ t͡sʲ
рэдкі	r ɛ d kʲ i
кірмаш	kʲ i r m a ʂ
атоесніць	a t ɔ j ɛ sʲ nʲ i t͡sʲ
высокаталенавіты	v ɨ s ɔ k a t a lʲ ɛ n a vʲ i t ɨ
знічка	zʲ nʲ i t͡ʂ k a
узараць	u z a r a t͡sʲ
занепакоіцца	z a nʲ ɛ p a k ɔ j i t͡sː a
затрызніць	z a t r ɨ zʲ nʲ i t͡sʲ
ганарлівец	ɣ a n a r lʲ i vʲ ɛ t͡s
перабудова	pʲ ɛ r a b u d ɔ v a
істужка	i s t u ʐ k a
адлічыць	a d lʲ i t͡ʂ ɨ t͡sʲ
першапачатковы	pʲ ɛ r ʂ a p a t͡ʂ a t k ɔ v ɨ
закучаравіцца	z a k u t͡ʂ a r a vʲ i t͡sː a
узаемаабумоўлены	u z a j ɛ m a a b u m ɔ w lʲ ɛ n ɨ
скіба	s kʲ i b a
паляскаць	p a lʲ a s k a t͡sʲ
парнасць	p a r n a sʲ t͡sʲ
папяліць	p a pʲ a lʲ i t͡sʲ
сасніць	s a sʲ nʲ i t͡sʲ
даведнік	d a vʲ ɛ d nʲ i k
ёг	j ɔ ɣ
залёгкі	z a lʲ ɔ ɣ kʲ i
карыслівы	k a r ɨ sʲ lʲ i v ɨ
рыба	r ɨ b a
шалупінне	ʂ a ɫ u pʲ i nʲː ɛ
прастамоўе	p r a s t a m ɔ w j ɛ
пярэдадне	pʲ a r ɛ d a d nʲ ɛ
цапаўё	t͡s a p a w j ɔ
прывітаць	p r ɨ vʲ i t a t͡sʲ
тупат	t u p a t
пакрасавацца	p a k r a s a v a t͡sː a
выстаўка	v ɨ s t a w k a
прымусіць	p r ɨ m u sʲ i t͡sʲ
прасоўка	p r a s ɔ w k a
дзяржаўнасць	d͡zʲ a r ʐ a w n a sʲ t͡sʲ
панафарбоўваць	p a n a f a r b ɔ w v a t͡sʲ
рак	r a k
ушчуць	u ʂ t͡ʂ u t͡sʲ
шынка	ʂ ɨ n k a
чырванаскуры	t͡ʂ ɨ r v a n a s k u r ɨ
хукнуць	x u k n u t͡sʲ
паперавыконваць	p a pʲ ɛ r a v ɨ k ɔ n v a t͡sʲ
светасузіранне	sʲ vʲ ɛ t a s u zʲ i r a nʲː ɛ
зіркаты	zʲ i r k a t ɨ
двухгадзінны	d v u x ɣ a d͡zʲ i nː ɨ
сціртаваць	sʲ t͡sʲ i r t a v a t͡sʲ
ссівець	sʲː i vʲ ɛ t͡sʲ
распрастаць	r a s p r a s t a t͡sʲ
змотвальнік	z m ɔ t v a lʲ nʲ i k
зраўнаваць	z r a w n a v a t͡sʲ
прынітаваць	p r ɨ nʲ i t a v a t͡sʲ
пралгацца	p r a ɫ ɣ a t͡sː a
здзічэць	z d͡zʲ i t͡ʂ ɛ t͡sʲ
раздумацца	r a z d u m a t͡sː a
кіраўніцтва	kʲ i r a w nʲ i t͡s t v a
залатоўка	z a ɫ a t ɔ w k a
спазніцца	s p a zʲ nʲ i t͡sː a
панарама	p a n a r a m a
роскід	r ɔ s kʲ i d
каўнер	k a w nʲ ɛ r
хваёвы	x v a j ɔ v ɨ
завішчаць	z a vʲ i ʂ t͡ʂ a t͡sʲ
перапіс	pʲ ɛ r a pʲ i s
зжоўкнуць	z ʐ ɔ w k n u t͡sʲ
ушчыльную	u ʂ t͡ʂ ɨ lʲ n u j u
аблічыць	a b lʲ i t͡ʂ ɨ t͡sʲ
пракласці	p r a k ɫ a sʲ t͡sʲ i
зусім	z u sʲ i m
жывёліна	ʐ ɨ vʲ ɔ lʲ i n a
цырульнік	t͡s ɨ r u lʲ nʲ i k
спраўдзіцца	s p r a w d͡zʲ i t͡sː a
пазапарушваць	p a z a p a r u ʂ v a t͡sʲ
угодкі	u ɣ ɔ d kʲ i
церушыць	t͡sʲ ɛ r u ʂ ɨ t͡sʲ
красамоўства	k r a s a m ɔ w s t v a
кветачніца	k vʲ ɛ t a t͡ʂ nʲ i t͡s a
выкрасці	v ɨ k r a sʲ t͡sʲ i
узгодненасць	u z ɣ ɔ d nʲ ɛ n a sʲ t͡sʲ
ураўнаважыць	u r a w n a v a ʐ ɨ t͡sʲ
працэнт	p r a t͡s ɛ n t
кідок	kʲ i d ɔ k
адгрэбці	a d ɣ r ɛ b t͡sʲ i
рассмакаваць	r a s s m a k a v a t͡sʲ
спавядальнік	s p a vʲ a d a lʲ nʲ i k
выфранціць	v ɨ f r a n t͡sʲ i t͡sʲ
пырхнуць	p ɨ r x n u t͡sʲ
літаральны	lʲ i t a r a lʲ n ɨ
наравіць	n a r a vʲ i t͡sʲ
перакамячыць	pʲ ɛ r a k a mʲ a t͡ʂ ɨ t͡sʲ
павітацца	p a vʲ i t a t͡sː a
перашалець	pʲ ɛ r a ʂ a lʲ ɛ t͡sʲ
аднарадкоўе	a d n a r a d k ɔ w j ɛ
вялікдзень	vʲ a lʲ i k d͡zʲ ɛ nʲ
валіць	v a lʲ i t͡sʲ
факультэт	f a k u lʲ t ɛ t
прышрубаваць	p r ɨ ʂ r u b a v a t͡sʲ
харчавацца	x a r t͡ʂ a v a t͡sː a
пусты	p u s t ɨ
лугазнаўства	ɫ u ɣ a z n a w s t v a
багністасць	b a ɣ nʲ i s t a sʲ t͡sʲ
двухмоўнасць	d v u x m ɔ w n a sʲ t͡sʲ
цыган	t͡s ɨ ɣ a n
памарудзіць	p a m a r u d͡zʲ i t͡sʲ
пазбавіць	p a z b a vʲ i t͡sʲ
справавод	s p r a v a v ɔ d
хапатлівы	x a p a t lʲ i v ɨ
посніца	p ɔ sʲ nʲ i t͡s a
прыхапіць	p r ɨ x a pʲ i t͡sʲ
чутка	t͡ʂ u t k a
ручнік	r u t͡ʂ nʲ i k
торкнуць	t ɔ r k n u t͡sʲ
спрактыкавацца	s p r a k t ɨ k a v a t͡sː a
самавіты	s a m a vʲ i t ɨ
забіяцкі	z a bʲ i j a t͡s kʲ i
пагадзінны	p a ɣ a d͡zʲ i nː ɨ
кампасціраваць	k a m p a sʲ t͡sʲ i r a v a t͡sʲ
ізноў	i z n ɔ w
спроба	s p r ɔ b a
самаробны	s a m a r ɔ b n ɨ
прымільгацца	p r ɨ mʲ i lʲ ɣ a t͡sː a
пазамалёўваць	p a z a m a lʲ ɔ w v a t͡sʲ
домакіраўніцтва	d ɔ m a kʲ i r a w nʲ i t͡s t v a
шукальнік	ʂ u k a lʲ nʲ i k
хвост	x v ɔ s t
навуказнаўства	n a v u k a z n a w s t v a
жэўжык	ʐ ɛ w ʐ ɨ k
увачавідкі	u v a t͡ʂ a vʲ i d kʲ i
спасцігнуць	s p a sʲ t͡sʲ i ɣ n u t͡sʲ
сунаймальнік	s u n a j m a lʲ nʲ i k
суадносны	s u a d n ɔ s n ɨ
стратны	s t r a t n ɨ
падлік	p a d lʲ i k
спыніць	s p ɨ nʲ i t͡sʲ
цэнтр	t͡s ɛ n t r
інакшы	i n a k ʂ ɨ
струхлець	s t r u x lʲ ɛ t͡sʲ
падгаіць	p a d ɣ a j i t͡sʲ
аскубці	a s k u b t͡sʲ i
падрыхтоўчы	p a d r ɨ x t ɔ w t͡ʂ ɨ
крамніна	k r a m nʲ i n a
слабізаваць	s ɫ a bʲ i z a v a t͡sʲ
перапрасіць	pʲ ɛ r a p r a sʲ i t͡sʲ
убараніць	u b a r a nʲ i t͡sʲ
сашморгаць	s a ʂ m ɔ r ɣ a t͡sʲ
памацаць	p a m a t͡s a t͡sʲ
сашрубаваць	s a ʂ r u b a v a t͡sʲ
намітка	n a mʲ i t k a
уласцівасць	u ɫ a sʲ t͡sʲ i v a sʲ t͡sʲ
паўзірацца	p a w zʲ i r a t͡sː a
абкітаваць	a b kʲ i t a v a t͡sʲ
віжаваць	vʲ i ʐ a v a t͡sʲ
раскудзеліць	r a s k u d͡zʲ ɛ lʲ i t͡sʲ
ухаваць	u x a v a t͡sʲ
плашч	p ɫ a ʂ t͡ʂ
высакамоўны	v ɨ s a k a m ɔ w n ɨ
лічыльшчык	lʲ i t͡ʂ ɨ lʲ ʂ t͡ʂ ɨ k
будпляцоўка	b u d p lʲ a t͡s ɔ w k a
пралюляць	p r a lʲ u lʲ a t͡sʲ
ваяўнічы	v a j a w nʲ i t͡ʂ ɨ
падлюстэрнік	p a d lʲ u s t ɛ r nʲ i k
неажыццявімы	nʲ ɛ a ʐ ɨ t͡sʲː a vʲ i m ɨ
шпаркі	ʂ p a r kʲ i
прадзед	p r a d͡zʲ ɛ d
мудрагелісты	m u d r a ɣʲ ɛ lʲ i s t ɨ
распорка	r a s p ɔ r k a
разгалінавацца	r a z ɣ a lʲ i n a v a t͡sː a
жаўнер	ʐ a w nʲ ɛ r
саўдзельнічаць	s a w d͡zʲ ɛ lʲ nʲ i t͡ʂ a t͡sʲ
суіснаваць	s u j i s n a v a t͡sʲ
рось	r ɔ sʲ
пярэбары	pʲ a r ɛ b a r ɨ
пападпальваць	p a p a d p a lʲ v a t͡sʲ
спісак	sʲ pʲ i s a k
вадзіць	v a d͡zʲ i t͡sʲ
прашугаць	p r a ʂ u ɣ a t͡sʲ
прагучаць	p r a ɣ u t͡ʂ a t͡sʲ
роспыт	r ɔ s p ɨ t
караціць	k a r a t͡sʲ i t͡sʲ
усечка	u sʲ ɛ t͡ʂ k a
нагаласіцца	n a ɣ a ɫ a sʲ i t͡sː a
ветлівы	vʲ ɛ t lʲ i v ɨ
паўстагоддзя	p a w s t a ɣ ɔ d͡zʲː a
крамнік	k r a m nʲ i k
карыслівасць	k a r ɨ sʲ lʲ i v a sʲ t͡sʲ
забаўка	z a b a w k a
паўмацоўваць	p a w m a t͡s ɔ w v a t͡sʲ
скарчанець	s k a r t͡ʂ a nʲ ɛ t͡sʲ
удзьмуць	u d zʲ m u t͡sʲ
руб	r u b
прычыніцца	p r ɨ t͡ʂ ɨ nʲ i t͡sː a
злоўжыванне	z ɫ ɔ w ʐ ɨ v a nʲː ɛ
па-сяброўску	p a - sʲ a b r ɔ w s k u
перад	pʲ ɛ r a d
пракоўзацца	p r a k ɔ w z a t͡sː a
сузалежнасць	s u z a lʲ ɛ ʐ n a sʲ t͡sʲ
паклікаць	p a k lʲ i k a t͡sʲ
мазлівы	m a zʲ lʲ i v ɨ
спустошыць	s p u s t ɔ ʂ ɨ t͡sʲ
лёдзісты	lʲ ɔ d͡zʲ i s t ɨ
заняволіць	z a nʲ a v ɔ lʲ i t͡sʲ
пацерушыць	p a t͡sʲ ɛ r u ʂ ɨ t͡sʲ
перакалаціць	pʲ ɛ r a k a ɫ a t͡sʲ i t͡sʲ
счарнець	s t͡ʂ a r nʲ ɛ t͡sʲ
трупярня	t r u pʲ a r nʲ a
улонне	u ɫ ɔ nʲː ɛ
параіцца	p a r a j i t͡sː a
няўрымслівы	nʲ a w r ɨ m sʲ lʲ i v ɨ
распрацаваць	r a s p r a t͡s a v a t͡sʲ
налупіць	n a ɫ u pʲ i t͡sʲ
цэнтральны	t͡s ɛ n t r a lʲ n ɨ
пятнастоўка	pʲ a t n a s t ɔ w k a
дзівакаваты	d͡zʲ i v a k a v a t ɨ
невынішчальны	nʲ ɛ v ɨ nʲ i ʂ t͡ʂ a lʲ n ɨ
згібіна	z ɣʲ i bʲ i n a
высілак	v ɨ sʲ i ɫ a k
трухляціна	t r u x lʲ a t͡sʲ i n a
пагадзіць	p a ɣ a d͡zʲ i t͡sʲ
перакласці	pʲ ɛ r a k ɫ a sʲ t͡sʲ i
пускаць	p u s k a t͡sʲ
агульнаўжывальнасць	a ɣ u lʲ n a w ʐ ɨ v a lʲ n a sʲ t͡sʲ
клічны	k lʲ i t͡ʂ n ɨ
распляскаць	r a s p lʲ a s k a t͡sʲ
стрыечны	s t r ɨ j ɛ t͡ʂ n ɨ
абсініць	a b sʲ i nʲ i t͡sʲ
даўгаствольны	d a w ɣ a s t v ɔ lʲ n ɨ
усёпераможны	u sʲ ɔ pʲ ɛ r a m ɔ ʐ n ɨ
перасаладзіць	pʲ ɛ r a s a ɫ a d͡zʲ i t͡sʲ
тапелец	t a pʲ ɛ lʲ ɛ t͡s
ліштва	lʲ i ʂ t v a
паскрэбці	p a s k r ɛ b t͡sʲ i
аўтакрама	a w t a k r a m a
парушыць	p a r u ʂ ɨ t͡sʲ
талачыць	t a ɫ a t͡ʂ ɨ t͡sʲ
расфарбаваць	r a s f a r b a v a t͡sʲ
аціснуць	a t͡sʲ i s n u t͡sʲ
схіл	s xʲ i ɫ
пераразлік	pʲ ɛ r a r a zʲ lʲ i k
бацькоўства	b a t͡sʲ k ɔ w s t v a
цямлівы	t͡sʲ a m lʲ i v ɨ
малпоўня	m a ɫ p ɔ w nʲ a
утушыць	u t u ʂ ɨ t͡sʲ
замыліць	z a m ɨ lʲ i t͡sʲ
пазавінавачвацца	p a z a vʲ i n a v a t͡ʂ v a t͡sː a
грузкі	ɣ r u z kʲ i
дзядзінец	d͡zʲ a d͡zʲ i nʲ ɛ t͡s
мастацкі	m a s t a t͡s kʲ i
гадавальнік	ɣ a d a v a lʲ nʲ i k
пярэбіркі	pʲ a r ɛ bʲ i r kʲ i
пухнаты	p u x n a t ɨ
захопнік	z a x ɔ p nʲ i k
растрыбушыць	r a s t r ɨ b u ʂ ɨ t͡sʲ
пераробка	pʲ ɛ r a r ɔ b k a
уводзіны	u v ɔ d͡zʲ i n ɨ
забавіцца	z a b a vʲ i t͡sː a
дробназярністы	d r ɔ b n a zʲ a r nʲ i s t ɨ
пераможца	pʲ ɛ r a m ɔ ʐ t͡s a
верадзіць	vʲ ɛ r a d͡zʲ i t͡sʲ
конегадоўля	k ɔ nʲ ɛ ɣ a d ɔ w lʲ a
далоў	d a ɫ ɔ w
звіх	zʲ vʲ i x
упрыгажэнне	u p r ɨ ɣ a ʐ ɛ nʲː ɛ
прадуха	p r a d u x a
затлусціць	z a t ɫ u sʲ t͡sʲ i t͡sʲ
улашчыць	u ɫ a ʂ t͡ʂ ɨ t͡sʲ
струменіцца	s t r u mʲ ɛ nʲ i t͡sː a
прыгарнуць	p r ɨ ɣ a r n u t͡sʲ
пераскварыць	pʲ ɛ r a s k v a r ɨ t͡sʲ
авіяздымка	a vʲ i j a z d ɨ m k a
няўдзячны	nʲ a w d͡zʲ a t͡ʂ n ɨ
напаўголасу	n a p a w ɣ ɔ ɫ a s u
прышчыкнуць	p r ɨ ʂ t͡ʂ ɨ k n u t͡sʲ
занаравіцца	z a n a r a vʲ i t͡sː a
тлумачальны	t ɫ u m a t͡ʂ a lʲ n ɨ
імгненны	i m ɣ nʲ ɛ nː ɨ
тлусціць	t ɫ u sʲ t͡sʲ i t͡sʲ
хітраваты	xʲ i t r a v a t ɨ
прасумаваць	p r a s u m a v a t͡sʲ
пара	p a r a
умалаціць	u m a ɫ a t͡sʲ i t͡sʲ
відовішча	vʲ i d ɔ vʲ i ʂ t͡ʂ a
спор	s p ɔ r
шабля	ʂ a b lʲ a
пасыхаць	p a s ɨ x a t͡sʲ
самаўшчыльніцца	s a m a w ʂ t͡ʂ ɨ lʲ nʲ i t͡sː a
пахіласць	p a xʲ i ɫ a sʲ t͡sʲ
паклёпнік	p a k lʲ ɔ p nʲ i k
навыціскаць	n a v ɨ t͡sʲ i s k a t͡sʲ
прагукаць	p r a ɣ u k a t͡sʲ
козагадоўля	k ɔ z a ɣ a d ɔ w lʲ a
язмін	j a zʲ mʲ i n
прапакутаваць	p r a p a k u t a v a t͡sʲ
зняславіць	zʲ nʲ a s ɫ a vʲ i t͡sʲ
радаўніца	r a d a w nʲ i t͡s a
адлік	a d lʲ i k
адрабіць	a d r a bʲ i t͡sʲ
купчасціцца	k u p t͡ʂ a sʲ t͡sʲ i t͡sː a
варыўня	v a r ɨ w nʲ a
загінуць	z a ɣʲ i n u t͡sʲ
паволі	p a v ɔ lʲ i
ледавік	lʲ ɛ d a vʲ i k
удосталь	u d ɔ s t a lʲ
чаргаваць	t͡ʂ a r ɣ a v a t͡sʲ
спалучыць	s p a ɫ u t͡ʂ ɨ t͡sʲ
спатрэбіць	s p a t r ɛ bʲ i t͡sʲ
аўтагурток	a w t a ɣ u r t ɔ k
цёк	t͡sʲ ɔ k
сям'я	sʲ a m j a
прыязнасць	p r ɨ j a z n a sʲ t͡sʲ
уголас	u ɣ ɔ ɫ a s
сасмажыць	s a s m a ʐ ɨ t͡sʲ
пракалаціцца	p r a k a ɫ a t͡sʲ i t͡sː a
патоля	p a t ɔ lʲ a
маўляў	m a w lʲ a w
працяць	p r a t͡sʲ a t͡sʲ
паўчвэрткі	p a w t͡ʂ v ɛ r t kʲ i
адхінуць	a d xʲ i n u t͡sʲ
гняўлівы	ɣ nʲ a w lʲ i v ɨ
зжаўцець	z ʐ a w t͡sʲ ɛ t͡sʲ
стогн	s t ɔ ɣ n
вельмі	vʲ ɛ lʲ mʲ i
церусіць	t͡sʲ ɛ r u sʲ i t͡sʲ
напярэдадні	n a pʲ a r ɛ d a d nʲ i
рунь	r u nʲ
закласці	z a k ɫ a sʲ t͡sʲ i
найкаштоўнейшы	n a j k a ʂ t ɔ w nʲ ɛ j ʂ ɨ
падліковец	p a d lʲ i k ɔ vʲ ɛ t͡s
гвалтаўнік	ɣ v a ɫ t a w nʲ i k
поплеч	p ɔ p lʲ ɛ t͡ʂ
ператварыць	pʲ ɛ r a t v a r ɨ t͡sʲ
паразмаўляць	p a r a z m a w lʲ a t͡sʲ
счыніць	s t͡ʂ ɨ nʲ i t͡sʲ
зоркаўка	z ɔ r k a w k a
наглядальнік	n a ɣ lʲ a d a lʲ nʲ i k
імбрычак	i m b r ɨ t͡ʂ a k
тагасветны	t a ɣ a sʲ vʲ ɛ t n ɨ
вітальны	vʲ i t a lʲ n ɨ
скалануцца	s k a ɫ a n u t͡sː a
іржышча	i r ʐ ɨ ʂ t͡ʂ a
пілаваць	pʲ i ɫ a v a t͡sʲ
знецярплівець	zʲ nʲ ɛ t͡sʲ a r p lʲ i vʲ ɛ t͡sʲ
прыпазніцца	p r ɨ p a zʲ nʲ i t͡sː a
шкада	ʂ k a d a
наўздагад	n a w z d a ɣ a d
заразлівы	z a r a zʲ lʲ i v ɨ
пазлоснічаць	p a z ɫ ɔ sʲ nʲ i t͡ʂ a t͡sʲ
растваральнік	r a s t v a r a lʲ nʲ i k
хлопец	x ɫ ɔ pʲ ɛ t͡s
сенажаць	sʲ ɛ n a ʐ a t͡sʲ
лічэбнік	lʲ i t͡ʂ ɛ b nʲ i k
кляніна	k lʲ a nʲ i n a
чараціна	t͡ʂ a r a t͡sʲ i n a
даводзіць	d a v ɔ d͡zʲ i t͡sʲ
раскрыжаваць	r a s k r ɨ ʐ a v a t͡sʲ
выпіхаць	v ɨ pʲ i x a t͡sʲ
стрыхоўка	s t r ɨ x ɔ w k a
пасціскаць	p a sʲ t͡sʲ i s k a t͡sʲ
неблагі	nʲ ɛ b ɫ a ɣʲ i
напышлівы	n a p ɨ ʂ lʲ i v ɨ
самавукам	s a m a v u k a m
расходнік	r a s x ɔ d nʲ i k
бабравіна	b a b r a vʲ i n a
падхіліць	p a d xʲ i lʲ i t͡sʲ
завадзіць	z a v a d͡zʲ i t͡sʲ
агаласоўка	a ɣ a ɫ a s ɔ w k a
дзівосы	d͡zʲ i v ɔ s ɨ
прыгорбіць	p r ɨ ɣ ɔ r bʲ i t͡sʲ
калмаціць	k a ɫ m a t͡sʲ i t͡sʲ
перасніць	pʲ ɛ r a sʲ nʲ i t͡sʲ
мікрарухавік	mʲ i k r a r u x a vʲ i k
саматужніцтва	s a m a t u ʐ nʲ i t͡s t v a
ускорасці	u s k ɔ r a sʲ t͡sʲ i
раскрадальнік	r a s k r a d a lʲ nʲ i k
усцешыць	u sʲ t͡sʲ ɛ ʂ ɨ t͡sʲ
куслівы	k u sʲ lʲ i v ɨ
другагоднік	d r u ɣ a ɣ ɔ d nʲ i k
паспрыяць	p a s p r ɨ j a t͡sʲ
шурпаты	ʂ u r p a t ɨ
крыніцазнаўства	k r ɨ nʲ i t͡s a z n a w s t v a
вынаходнік	v ɨ n a x ɔ d nʲ i k
угарадзіць	u ɣ a r a d͡zʲ i t͡sʲ
тынкоўшчык	t ɨ n k ɔ w ʂ t͡ʂ ɨ k
абхапіць	a b x a pʲ i t͡sʲ
пацяруха	p a t͡sʲ a r u x a
прысніць	p r ɨ sʲ nʲ i t͡sʲ
маніць	m a nʲ i t͡sʲ
змарозіць	z m a r ɔ zʲ i t͡sʲ
узімку	u zʲ i m k u
уточка	u t ɔ t͡ʂ k a
нарабіць	n a r a bʲ i t͡sʲ
чатыры	t͡ʂ a t ɨ r ɨ
усходазнаўства	u s x ɔ d a z n a w s t v a
скрывадушнічаць	s k r ɨ v a d u ʂ nʲ i t͡ʂ a t͡sʲ
разварушыць	r a z v a r u ʂ ɨ t͡sʲ
харашэйшы	x a r a ʂ ɛ j ʂ ɨ
выкараніць	v ɨ k a r a nʲ i t͡sʲ
паўночны	p a w n ɔ t͡ʂ n ɨ
павінен	p a vʲ i nʲ ɛ n
пераймальнік	pʲ ɛ r a j m a lʲ nʲ i k
выбліснуць	v ɨ b lʲ i s n u t͡sʲ
страпянуць	s t r a pʲ a n u t͡sʲ
пралік	p r a lʲ i k
колькі	k ɔ lʲ kʲ i
паласавацца	p a ɫ a s a v a t͡sː a
паўгадзіны	p a w ɣ a d͡zʲ i n ɨ
пераабсталяваць	pʲ ɛ r a a b s t a lʲ a v a t͡sʲ
гнездзішча	ɣ nʲ ɛ z d͡zʲ i ʂ t͡ʂ a
каралі	k a r a lʲ i
упэўніць	u p ɛ w nʲ i t͡sʲ
пакоўзацца	p a k ɔ w z a t͡sː a
уздрыгнуць	u z d r ɨ ɣ n u t͡sʲ
фотанарыс	f ɔ t a n a r ɨ s
пазвалакаць	p a z v a ɫ a k a t͡sʲ
ліслівы	lʲ i sʲ lʲ i v ɨ
жаўтлявы	ʐ a w t lʲ a v ɨ
учуць	u t͡ʂ u t͡sʲ
угневацца	u ɣ nʲ ɛ v a t͡sː a
вэнджаніна	v ɛ n d ʐ a nʲ i n a
папярэдзіць	p a pʲ a r ɛ d͡zʲ i t͡sʲ
перажлукціць	pʲ ɛ r a ʐ ɫ u k t͡sʲ i t͡sʲ
кіпцюр	kʲ i p t͡sʲ u r
аякасціць	a j a k a sʲ t͡sʲ i t͡sʲ
стракаціна	s t r a k a t͡sʲ i n a
працягваць	p r a t͡sʲ a ɣ v a t͡sʲ
ветлівасць	vʲ ɛ t lʲ i v a sʲ t͡sʲ
выдзеўбці	v ɨ d͡zʲ ɛ w b t͡sʲ i
спакусіць	s p a k u sʲ i t͡sʲ
прыметнік	p r ɨ mʲ ɛ t nʲ i k
выдзімаць	v ɨ d͡zʲ i m a t͡sʲ
збэсціць	z b ɛ sʲ t͡sʲ i t͡sʲ
звыштэрміновы	z v ɨ ʂ t ɛ r mʲ i n ɔ v ɨ
цнатлівы	t͡s n a t lʲ i v ɨ
каштоўны	k a ʂ t ɔ w n ɨ
другі	d r u ɣʲ i
раўчук	r a w t͡ʂ u k
паабвінавачваць	p a a b vʲ i n a v a t͡ʂ v a t͡sʲ
наўмысны	n a w m ɨ s n ɨ
дакорлівы	d a k ɔ r lʲ i v ɨ
мітрэнжыць	mʲ i t r ɛ n ʐ ɨ t͡sʲ
пачакаць	p a t͡ʂ a k a t͡sʲ
спрахнуць	s p r a x n u t͡sʲ
таўхануць	t a w x a n u t͡sʲ
прамова	p r a m ɔ v a
абачлівасць	a b a t͡ʂ lʲ i v a sʲ t͡sʲ
прыцішэць	p r ɨ t͡sʲ i ʂ ɛ t͡sʲ
чыгунка	t͡ʂ ɨ ɣ u n k a
малазмястоўны	m a ɫ a zʲ mʲ a s t ɔ w n ɨ
нібы	nʲ i b ɨ
прымежны	p r ɨ mʲ ɛ ʐ n ɨ
павіншаваць	p a vʲ i n ʂ a v a t͡sʲ
скалануць	s k a ɫ a n u t͡sʲ
улучыць	u ɫ u t͡ʂ ɨ t͡sʲ
паматляць	p a m a t lʲ a t͡sʲ
палон	p a ɫ ɔ n
бавіцца	b a vʲ i t͡sː a
квапіцца	k v a pʲ i t͡sː a
лёгкаўзброены	lʲ ɔ ɣ k a w z b r ɔ j ɛ n ɨ
адсутнічаць	a d s u t nʲ i t͡ʂ a t͡sʲ
падупасці	p a d u p a sʲ t͡sʲ i
сцяміць	sʲ t͡sʲ a mʲ i t͡sʲ
пазакітоўваць	p a z a kʲ i t ɔ w v a t͡sʲ
дравяністы	d r a vʲ a nʲ i s t ɨ
здрбдлівасць	z d r b d lʲ i v a sʲ t͡sʲ
заблудзіць	z a b ɫ u d͡zʲ i t͡sʲ
дзяўчына	d͡zʲ a w t͡ʂ ɨ n a
пахадайнічаць	p a x a d a j nʲ i t͡ʂ a t͡sʲ
тронкі	t r ɔ n kʲ i
багавінне	b a ɣ a vʲ i nʲː ɛ
кеміць	kʲ ɛ mʲ i t͡sʲ
секануць	sʲ ɛ k a n u t͡sʲ
няцямлівы	nʲ a t͡sʲ a m lʲ i v ɨ
фельчар	fʲ ɛ lʲ t͡ʂ a r
хіліцца	xʲ i lʲ i t͡sː a
прызначыць	p r ɨ z n a t͡ʂ ɨ t͡sʲ
насваволіць	n a s v a v ɔ lʲ i t͡sʲ
набрудзіць	n a b r u d͡zʲ i t͡sʲ
паўсаматужны	p a w s a m a t u ʐ n ɨ
халоднае	x a ɫ ɔ d n a j ɛ
пасашморгваць	p a s a ʂ m ɔ r ɣ v a t͡sʲ
радок	r a d ɔ k
павыпрасоўваць	p a v ɨ p r a s ɔ w v a t͡sʲ
двухаблічны	d v u x a b lʲ i t͡ʂ n ɨ
жартаўлівы	ʐ a r t a w lʲ i v ɨ
пасумаваць	p a s u m a v a t͡sʲ
саслабець	s a s ɫ a bʲ ɛ t͡sʲ
вудзільна	v u d͡zʲ i lʲ n a
вытруціць	v ɨ t r u t͡sʲ i t͡sʲ
падхапіцца	p a d x a pʲ i t͡sː a
патрываць	p a t r ɨ v a t͡sʲ
паадкрэсліваць	p a a d k r ɛ sʲ lʲ i v a t͡sʲ
блудзіць	b ɫ u d͡zʲ i t͡sʲ
раскласці	r a s k ɫ a sʲ t͡sʲ i
нясціплы	nʲ a sʲ t͡sʲ i p ɫ ɨ
стол	s t ɔ ɫ
цяпліць	t͡sʲ a p lʲ i t͡sʲ
будоўля	b u d ɔ w lʲ a
плойма	p ɫ ɔ j m a
ваўняны	v a w nʲ a n ɨ
заваёўнік	z a v a j ɔ w nʲ i k
прапоркацца	p r a p ɔ r k a t͡sː a
рамізніцтва	r a mʲ i zʲ nʲ i t͡s t v a
выпрацоўка	v ɨ p r a t͡s ɔ w k a
ломкі	ɫ ɔ m kʲ i
лісянё	lʲ i sʲ a nʲ ɔ
зыходзіць	z ɨ x ɔ d͡zʲ i t͡sʲ
палаяць	p a ɫ a j a t͡sʲ
прозвішча	p r ɔ zʲ vʲ i ʂ t͡ʂ a
папілаваць	p a pʲ i ɫ a v a t͡sʲ
паўнамоцтва	p a w n a m ɔ t͡s t v a
сцёбнуць	sʲ t͡sʲ ɔ b n u t͡sʲ
паўнатвары	p a w n a t v a r ɨ
каляплоднік	k a lʲ a p ɫ ɔ d nʲ i k
грэблівы	ɣ r ɛ b lʲ i v ɨ
тыповы	t ɨ p ɔ v ɨ
даступіць	d a s t u pʲ i t͡sʲ
часнок	t͡ʂ a s n ɔ k
пупышка	p u p ɨ ʂ k a
цікавы	t͡sʲ i k a v ɨ
прыкры	p r ɨ k r ɨ
спяліць	sʲ pʲ a lʲ i t͡sʲ
трохмоўны	t r ɔ x m ɔ w n ɨ
досціп	d ɔ sʲ t͡sʲ i p
ускрай	u s k r a j
двухмоўе	d v u x m ɔ w j ɛ
парумзаць	p a r u m z a t͡sʲ
удоўж	u d ɔ w ʐ
пляцоўка	p lʲ a t͡s ɔ w k a
пасівець	p a sʲ i vʲ ɛ t͡sʲ
злавіць	z ɫ a vʲ i t͡sʲ
памякчыць	p a mʲ a k t͡ʂ ɨ t͡sʲ
перакладаць	pʲ ɛ r a k ɫ a d a t͡sʲ
краявід	k r a j a vʲ i d
пазвальняць	p a z v a lʲ nʲ a t͡sʲ
пэндзлік	p ɛ n d͡zʲ lʲ i k
расцерці	r a sʲ t͡sʲ ɛ r t͡sʲ i
пашырыць	p a ʂ ɨ r ɨ t͡sʲ
сшэрхнуць	s ʂ ɛ r x n u t͡sʲ
пацукалоў	p a t͡s u k a ɫ ɔ w
склюдаваць	s k lʲ u d a v a t͡sʲ
выбраннік	v ɨ b r a nʲː i k
угрэць	u ɣ r ɛ t͡sʲ
таўханіна	t a w x a nʲ i n a
падагуліць	p a d a ɣ u lʲ i t͡sʲ
авысакародзіць	a v ɨ s a k a r ɔ d͡zʲ i t͡sʲ
усперці	u sʲ pʲ ɛ r t͡sʲ i
адліваны	a d lʲ i v a n ɨ
перадраць	pʲ ɛ r a d r a t͡sʲ
зрэдзіць	z r ɛ d͡zʲ i t͡sʲ
бацькаўшчына	b a t͡sʲ k a w ʂ t͡ʂ ɨ n a
першарадны	pʲ ɛ r ʂ a r a d n ɨ
згадзіцца	z ɣ a d͡zʲ i t͡sː a
размывіна	r a z m ɨ vʲ i n a
спужаць	s p u ʐ a t͡sʲ
выхапіць	v ɨ x a pʲ i t͡sʲ
хаціна	x a t͡sʲ i n a
цкаваць	t͡s k a v a t͡sʲ
лапнік	ɫ a p nʲ i k
леташні	lʲ ɛ t a ʂ nʲ i
сачавіца	s a t͡ʂ a vʲ i t͡s a
разгайдаць	r a z ɣ a j d a t͡sʲ
паплаўнічы	p a p ɫ a w nʲ i t͡ʂ ɨ
ганарлівы	ɣ a n a r lʲ i v ɨ
рот	r ɔ t
дапаможнік	d a p a m ɔ ʐ nʲ i k
выкінуць	v ɨ kʲ i n u t͡sʲ
падрыхтоўка	p a d r ɨ x t ɔ w k a
коўзацца	k ɔ w z a t͡sː a
нападкрэсліваць	n a p a d k r ɛ sʲ lʲ i v a t͡sʲ
іншамоўны	i n ʂ a m ɔ w n ɨ
калі-нікалі	k a lʲ i - nʲ i k a lʲ i
перавод	pʲ ɛ r a v ɔ d
фарбоўнік	f a r b ɔ w nʲ i k
спорт	s p ɔ r t
гарэзлівы	ɣ a r ɛ zʲ lʲ i v ɨ
вішчаць	vʲ i ʂ t͡ʂ a t͡sʲ
трапяткі	t r a pʲ a t kʲ i
бытапісец	b ɨ t a pʲ i sʲ ɛ t͡s
шмат	ʂ m a t
каморніцтва	k a m ɔ r nʲ i t͡s t v a
нацяпліць	n a t͡sʲ a p lʲ i t͡sʲ
рассунуть	r a s s u n u tʲ
папачакаць	p a p a t͡ʂ a k a t͡sʲ
сусед	s u sʲ ɛ d
абанкруціцца	a b a n k r u t͡sʲ i t͡sː a
рука	r u k a
занудзіць	z a n u d͡zʲ i t͡sʲ
наперстаўка	n a pʲ ɛ r s t a w k a
засудзіць	z a s u d͡zʲ i t͡sʲ
прыстарацца	p r ɨ s t a r a t͡sː a
пашвэндацца	p a ʂ v ɛ n d a t͡sː a
пазгортваць	p a z ɣ ɔ r t v a t͡sʲ
пасмуціцца	p a s m u t͡sʲ i t͡sː a
пры	p r ɨ
пакарыстацца	p a k a r ɨ s t a t͡sː a
хавальнік	x a v a lʲ nʲ i k
перамагчы	pʲ ɛ r a m a ɣ t͡ʂ ɨ
пасклюдаваць	p a s k lʲ u d a v a t͡sʲ
замітусіцца	z a mʲ i t u sʲ i t͡sː a
пялюшка	pʲ a lʲ u ʂ k a
прымеркнуць	p r ɨ mʲ ɛ r k n u t͡sʲ
светла-блакітны	sʲ vʲ ɛ t ɫ a - b ɫ a kʲ i t n ɨ
вынік	v ɨ nʲ i k
згвалціць	z ɣ v a ɫ t͡sʲ i t͡sʲ
сцішыць	sʲ t͡sʲ i ʂ ɨ t͡sʲ
мясціна	mʲ a sʲ t͡sʲ i n a
паквапіцца	p a k v a pʲ i t͡sː a
парода	p a r ɔ d a
кій	kʲ i j
тапырыць	t a p ɨ r ɨ t͡sʲ
вышкі	v ɨ ʂ kʲ i
запрасці	z a p r a sʲ t͡sʲ i
людскі	lʲ u d s kʲ i
атлуміць	a t ɫ u mʲ i t͡sʲ
ровар	r ɔ v a r
сквапнасць	s k v a p n a sʲ t͡sʲ
угледзець	u ɣ lʲ ɛ d͡zʲ ɛ t͡sʲ
наяўны	n a j a w n ɨ
нястрогі	nʲ a s t r ɔ ɣʲ i
слава	s ɫ a v a
разладдзе	r a z ɫ a d͡zʲː ɛ
прасякнуць	p r a sʲ a k n u t͡sʲ
перапражыць	pʲ ɛ r a p r a ʐ ɨ t͡sʲ
звяглівы	zʲ vʲ a ɣ lʲ i v ɨ
якасць	j a k a sʲ t͡sʲ
прывілея	p r ɨ vʲ i lʲ ɛ j a
падаўжэць	p a d a w ʐ ɛ t͡sʲ
пахапаць	p a x a p a t͡sʲ
улік	u lʲ i k
вымусіць	v ɨ m u sʲ i t͡sʲ
замагільны	z a m a ɣʲ i lʲ n ɨ
паўразбураны	p a w r a z b u r a n ɨ
рунець	r u nʲ ɛ t͡sʲ
паўабаронца	p a w a b a r ɔ n t͡s a
імжэць	i m ʐ ɛ t͡sʲ
абскардзіць	a b s k a r d͡zʲ i t͡sʲ
бестэрміновы	bʲ ɛ s t ɛ r mʲ i n ɔ v ɨ
процілеглы	p r ɔ t͡sʲ i lʲ ɛ ɣ ɫ ɨ
хаўруснічаць	x a w r u sʲ nʲ i t͡ʂ a t͡sʲ
складальнік	s k ɫ a d a lʲ nʲ i k
боцікі	b ɔ t͡sʲ i kʲ i
выхавальнік	v ɨ x a v a lʲ nʲ i k
прыслоўе	p r ɨ s ɫ ɔ w j ɛ
паразбіральнік	p a r a zʲ bʲ i r a lʲ nʲ i k
зладзіць	z ɫ a d͡zʲ i t͡sʲ
падсілкаваць	p a d sʲ i ɫ k a v a t͡sʲ
прыбіральшчыца	p r ɨ bʲ i r a lʲ ʂ t͡ʂ ɨ t͡s a
перакладчык	pʲ ɛ r a k ɫ a t͡ʂː ɨ k
раскалмаціць	r a s k a ɫ m a t͡sʲ i t͡sʲ
тэлечасопіс	t ɛ lʲ ɛ t͡ʂ a s ɔ pʲ i s
паўшклянкі	p a w ʂ k lʲ a n kʲ i
пратлусціць	p r a t ɫ u sʲ t͡sʲ i t͡sʲ
кашлаціць	k a ʂ ɫ a t͡sʲ i t͡sʲ
боскі	b ɔ s kʲ i
нагрэбці	n a ɣ r ɛ b t͡sʲ i
пагаіцца	p a ɣ a j i t͡sː a
наўздзіў	n a w z d͡zʲ i w
дзядоўнік	d͡zʲ a d ɔ w nʲ i k
спусцісты	s p u sʲ t͡sʲ i s t ɨ
замілаваць	z a mʲ i ɫ a v a t͡sʲ
пагадзіцца	p a ɣ a d͡zʲ i t͡sː a
умомант	u m ɔ m a n t
прапакосціць	p r a p a k ɔ sʲ t͡sʲ i t͡sʲ
грамадазнаўства	ɣ r a m a d a z n a w s t v a
сітаватасць	sʲ i t a v a t a sʲ t͡sʲ
даўгавечны	d a w ɣ a vʲ ɛ t͡ʂ n ɨ
праўдашукальнік	p r a w d a ʂ u k a lʲ nʲ i k
ліхадум	lʲ i x a d u m
літара	lʲ i t a r a
ціснуць	t͡sʲ i s n u t͡sʲ
грымзоліць	ɣ r ɨ m z ɔ lʲ i t͡sʲ
багністы	b a ɣ nʲ i s t ɨ
самазагартоўка	s a m a z a ɣ a r t ɔ w k a
праскрэбці	p r a s k r ɛ b t͡sʲ i
капліца	k a p lʲ i t͡s a
стукат	s t u k a t
павярэдзіць	p a vʲ a r ɛ d͡zʲ i t͡sʲ
уяўленне	u j a w lʲ ɛ nʲː ɛ
вінаваціць	vʲ i n a v a t͡sʲ i t͡sʲ
сціслы	sʲ t͡sʲ i s ɫ ɨ
паружовіць	p a r u ʐ ɔ vʲ i t͡sʲ
сустракаць	s u s t r a k a t͡sʲ
паўабарона	p a w a b a r ɔ n a
споднікі	s p ɔ d nʲ i kʲ i
прытуліць	p r ɨ t u lʲ i t͡sʲ
бакавіца	b a k a vʲ i t͡s a
разрэдзіць	r a z r ɛ d͡zʲ i t͡sʲ
перадсвяточны	pʲ ɛ r a d sʲ vʲ a t ɔ t͡ʂ n ɨ
замарудзіць	z a m a r u d͡zʲ i t͡sʲ
сальнік	s a lʲ nʲ i k
рашэціна	r a ʂ ɛ t͡sʲ i n a
хуткаплынны	x u t k a p ɫ ɨ nː ɨ
подбіўка	p ɔ d bʲ i w k a
гнаявік	ɣ n a j a vʲ i k
паслянаціскны	p a sʲ lʲ a n a t͡sʲ i s k n ɨ
выгнаннік	v ɨ ɣ n a nʲː i k
разбудаваць	r a z b u d a v a t͡sʲ
праблукаць	p r a b ɫ u k a t͡sʲ
назоўнік	n a z ɔ w nʲ i k
шумець	ʂ u mʲ ɛ t͡sʲ
пакудлачыць	p a k u d ɫ a t͡ʂ ɨ t͡sʲ
покатам	p ɔ k a t a m
малалікасць	m a ɫ a lʲ i k a sʲ t͡sʲ
між	mʲ i ʐ
пачынальнік	p a t͡ʂ ɨ n a lʲ nʲ i k
успудзіць	u s p u d͡zʲ i t͡sʲ
злотнік	z ɫ ɔ t nʲ i k
абумовіць	a b u m ɔ vʲ i t͡sʲ
паўпразрысты	p a w p r a z r ɨ s t ɨ
ёта	j ɔ t a
сівавалосы	sʲ i v a v a ɫ ɔ s ɨ
чалавек	t͡ʂ a ɫ a vʲ ɛ k
рашуча	r a ʂ u t͡ʂ a
распрасаваць	r a s p r a s a v a t͡sʲ
грымотнік	ɣ r ɨ m ɔ t nʲ i k
пагаласіць	p a ɣ a ɫ a sʲ i t͡sʲ
падшавяліць	p a d ʂ a vʲ a lʲ i t͡sʲ
паспяшацца	p a sʲ pʲ a ʂ a t͡sː a
шарэць	ʂ a r ɛ t͡sʲ
саманарыхтоўка	s a m a n a r ɨ x t ɔ w k a
паспешлівы	p a sʲ pʲ ɛ ʂ lʲ i v ɨ
поўнач	p ɔ w n a t͡ʂ
загрувасціць	z a ɣ r u v a sʲ t͡sʲ i t͡sʲ
высоўваць	v ɨ s ɔ w v a t͡sʲ
выканаўчасць	v ɨ k a n a w t͡ʂ a sʲ t͡sʲ
разгаманіцца	r a z ɣ a m a nʲ i t͡sː a
асабліва	a s a b lʲ i v a
кратавінне	k r a t a vʲ i nʲː ɛ
смоўж	s m ɔ w ʐ
процідзеянне	p r ɔ t͡sʲ i d͡zʲ ɛ j a nʲː ɛ
парасплюхваць	p a r a s p lʲ u x v a t͡sʲ
дурніцы	d u r nʲ i t͡s ɨ
развалкі	r a z v a ɫ kʲ i
абшалёўка	a b ʂ a lʲ ɔ w k a
птушнік	p t u ʂ nʲ i k
сачавічнішча	s a t͡ʂ a vʲ i t͡ʂ nʲ i ʂ t͡ʂ a
жардзянік	ʐ a r d͡zʲ a nʲ i k
раскамячыць	r a s k a mʲ a t͡ʂ ɨ t͡sʲ
прыхінуць	p r ɨ xʲ i n u t͡sʲ
схованка	s x ɔ v a n k a
завузіць	z a v u zʲ i t͡sʲ
асаблівасць	a s a b lʲ i v a sʲ t͡sʲ
канаплянік	k a n a p lʲ a nʲ i k
сашчаміць	s a ʂ t͡ʂ a mʲ i t͡sʲ
атаясамліванне	a t a j a s a m lʲ i v a nʲː ɛ
прыстасаванне	p r ɨ s t a s a v a nʲː ɛ
пазатульваць	p a z a t u lʲ v a t͡sʲ
выбіральны	v ɨ bʲ i r a lʲ n ɨ
прырабіць	p r ɨ r a bʲ i t͡sʲ
назалічаць	n a z a lʲ i t͡ʂ a t͡sʲ
парэчкі	p a r ɛ t͡ʂ kʲ i
марозаўстойлівы	m a r ɔ z a w s t ɔ j lʲ i v ɨ
скарэць	s k a r ɛ t͡sʲ
натхніць	n a t x nʲ i t͡sʲ
трохгадзінны	t r ɔ x ɣ a d͡zʲ i nː ɨ
самасвядомасць	s a m a sʲ vʲ a d ɔ m a sʲ t͡sʲ
цудатворны	t͡s u d a t v ɔ r n ɨ
слізганка	sʲ lʲ i z ɣ a n k a
крэсіва	k r ɛ sʲ i v a
азіраць	a zʲ i r a t͡sʲ
волкі	v ɔ ɫ kʲ i
абкруціць	a b k r u t͡sʲ i t͡sʲ
напляміць	n a p lʲ a mʲ i t͡sʲ
спаліць	s p a lʲ i t͡sʲ
папаліраваць	p a p a lʲ i r a v a t͡sʲ
склікаць	s k lʲ i k a t͡sʲ
пагаліцца	p a ɣ a lʲ i t͡sː a
пэўны	p ɛ w n ɨ
сцірта	sʲ t͡sʲ i r t a
парцаляна	p a r t͡s a lʲ a n a
пераборы	pʲ ɛ r a b ɔ r ɨ
даўбешка	d a w bʲ ɛ ʂ k a
ляднік	lʲ a d nʲ i k
жаўна	ʐ a w n a
перавыдатак	pʲ ɛ r a v ɨ d a t a k
прыхлусіць	p r ɨ x ɫ u sʲ i t͡sʲ
грувасціць	ɣ r u v a sʲ t͡sʲ i t͡sʲ
брыдкі	b r ɨ d kʲ i
узначаліць	u z n a t͡ʂ a lʲ i t͡sʲ
расцерабіць	r a sʲ t͡sʲ ɛ r a bʲ i t͡sʲ
падлізлівы	p a d lʲ i zʲ lʲ i v ɨ
задзяўбці	z a d͡zʲ a w b t͡sʲ i
заўжды	z a w ʐ d ɨ
спусташальнік	s p u s t a ʂ a lʲ nʲ i k
сутонець	s u t ɔ nʲ ɛ t͡sʲ
харчовы	x a r t͡ʂ ɔ v ɨ
крынічыць	k r ɨ nʲ i t͡ʂ ɨ t͡sʲ
своеасаблівы	s v ɔ j ɛ a s a b lʲ i v ɨ
вяшчальнік	vʲ a ʂ t͡ʂ a lʲ nʲ i k
стваральны	s t v a r a lʲ n ɨ
прыскорыць	p r ɨ s k ɔ r ɨ t͡sʲ
маркоўнік	m a r k ɔ w nʲ i k
авіяпадарожжа	a vʲ i j a p a d a r ɔ ʐ ʐ a
самазахаванне	s a m a z a x a v a nʲː ɛ
парадак	p a r a d a k
паашалёўваць	p a a ʂ a lʲ ɔ w v a t͡sʲ
істотны	i s t ɔ t n ɨ
расіць	r a sʲ i t͡sʲ
дакучлівы	d a k u t͡ʂ lʲ i v ɨ
капытнік	k a p ɨ t nʲ i k
перазнаёміць	pʲ ɛ r a z n a j ɔ mʲ i t͡sʲ
расскародзіць	r a s s k a r ɔ d͡zʲ i t͡sʲ
таямнічы	t a j a m nʲ i t͡ʂ ɨ
прадажнік	p r a d a ʐ nʲ i k
паўрасчынены	p a w r a s t͡ʂ ɨ nʲ ɛ n ɨ
пілавінне	pʲ i ɫ a vʲ i nʲː ɛ
супакоіць	s u p a k ɔ j i t͡sʲ
папытаць	p a p ɨ t a t͡sʲ
узварухнуць	u z v a r u x n u t͡sʲ
цішком	t͡sʲ i ʂ k ɔ m
ружовіць	r u ʐ ɔ vʲ i t͡sʲ
зносаўстойлівы	z n ɔ s a w s t ɔ j lʲ i v ɨ
аксамітнік	a k s a mʲ i t nʲ i k
чарніцы	t͡ʂ a r nʲ i t͡s ɨ
папастраляць	p a p a s t r a lʲ a t͡sʲ
закітоўка	z a kʲ i t ɔ w k a
лапіна	ɫ a pʲ i n a
пяцісотгоддзе	pʲ a t͡sʲ i s ɔ t ɣ ɔ d͡zʲː ɛ
прыблізны	p r ɨ b lʲ i z n ɨ
хутка	x u t k a
воўна	v ɔ w n a
палавініць	p a ɫ a vʲ i nʲ i t͡sʲ
шкарпэткі	ʂ k a r p ɛ t kʲ i
пассыпаць	p a s s ɨ p a t͡sʲ
кастрычнік	k a s t r ɨ t͡ʂ nʲ i k
наяўнасць	n a j a w n a sʲ t͡sʲ
выпагадзіцца	v ɨ p a ɣ a d͡zʲ i t͡sː a
тлумач	t ɫ u m a t͡ʂ
свінакроп	sʲ vʲ i n a k r ɔ p
заглеіцца	z a ɣ lʲ ɛ j i t͡sː a
швагер	ʂ v a ɣʲ ɛ r
ёмістасць	j ɔ mʲ i s t a sʲ t͡sʲ
прамалёўка	p r a m a lʲ ɔ w k a
пагардлівы	p a ɣ a r d lʲ i v ɨ
замерці	z a mʲ ɛ r t͡sʲ i
быльнік	b ɨ lʲ nʲ i k
згрувасціць	z ɣ r u v a sʲ t͡sʲ i t͡sʲ
прадстаўнік	p r a d s t a w nʲ i k
прызначаць	p r ɨ z n a t͡ʂ a t͡sʲ
змясціць	zʲ mʲ a sʲ t͡sʲ i t͡sʲ
націснуць	n a t͡sʲ i s n u t͡sʲ
драбіны	d r a bʲ i n ɨ
чарка	t͡ʂ a r k a
уздзець	u z d͡zʲ ɛ t͡sʲ
сопкі	s ɔ p kʲ i
памацнець	p a m a t͡sʲ nʲ ɛ t͡sʲ
утаропіць	u t a r ɔ pʲ i t͡sʲ
аднаўленне	a d n a w lʲ ɛ nʲː ɛ
нячысцік	nʲ a t͡ʂ ɨ sʲ t͡sʲ i k
аблупіць	a b ɫ u pʲ i t͡sʲ
участаваць	u t͡ʂ a s t a v a t͡sʲ
тлумны	t ɫ u m n ɨ
лагодзіць	ɫ a ɣ ɔ d͡zʲ i t͡sʲ
галасіць	ɣ a ɫ a sʲ i t͡sʲ
папераніцоўваць	p a pʲ ɛ r a nʲ i t͡s ɔ w v a t͡sʲ
біскуп	bʲ i s k u p
аблезці	a b lʲ ɛ zʲ t͡sʲ i
кветалісцік	k vʲ ɛ t a lʲ i sʲ t͡sʲ i k
спяшацца	sʲ pʲ a ʂ a t͡sː a
парассяляць	p a r a sʲː a lʲ a t͡sʲ
паспаборнічаць	p a s p a b ɔ r nʲ i t͡ʂ a t͡sʲ
суніцы	s u nʲ i t͡s ɨ
выбоісты	v ɨ b ɔ j i s t ɨ
пакоўны	p a k ɔ w n ɨ
неабачлівы	nʲ ɛ a b a t͡ʂ lʲ i v ɨ
няўрокам	nʲ a w r ɔ k a m
баброўнік	b a b r ɔ w nʲ i k
адшпіліць	a d ʂ pʲ i lʲ i t͡sʲ
зманлівы	z m a n lʲ i v ɨ
паўнавагавы	p a w n a v a ɣ a v ɨ
саладкакорань	s a ɫ a d k a k ɔ r a nʲ
пратрызніць	p r a t r ɨ zʲ nʲ i t͡sʲ
пяціпавярховы	pʲ a t͡sʲ i p a vʲ a r x ɔ v ɨ
прайдзісвет	p r a j d͡zʲ i sʲ vʲ ɛ t
няўтульны	nʲ a w t u lʲ n ɨ
ушушкацца	u ʂ u ʂ k a t͡sː a
паўжыцця	p a w ʐ ɨ t͡sʲː a
дзіванна	d͡zʲ i v a nː a
паўасьміна	p a w a sʲ mʲ i n a
падшалёўка	p a d ʂ a lʲ ɔ w k a
парадзіць	p a r a d͡zʲ i t͡sʲ
пляміць	p lʲ a mʲ i t͡sʲ
нішчымны	nʲ i ʂ t͡ʂ ɨ m n ɨ
спадніца	s p a d nʲ i t͡s a
паэтычны	p a ɛ t ɨ t͡ʂ n ɨ
даволі	d a v ɔ lʲ i
галушкі	ɣ a ɫ u ʂ kʲ i
мігатлівы	mʲ i ɣ a t lʲ i v ɨ
ацяпляльнік	a t͡sʲ a p lʲ a lʲ nʲ i k
творны	t v ɔ r n ɨ
пярэбірак	pʲ a r ɛ bʲ i r a k
родны	r ɔ d n ɨ
фасоліна	f a s ɔ lʲ i n a
злараднічаць	z ɫ a r a d nʲ i t͡ʂ a t͡sʲ
надрабіць	n a d r a bʲ i t͡sʲ
перакаштаваць	pʲ ɛ r a k a ʂ t a v a t͡sʲ
падагульніць	p a d a ɣ u lʲ nʲ i t͡sʲ
прагінаць	p r a ɣʲ i n a t͡sʲ
даніна	d a nʲ i n a
шкілет	ʂ kʲ i lʲ ɛ t
газіфікаваць	ɣ a zʲ i fʲ i k a v a t͡sʲ
аленегадоўля	a lʲ ɛ nʲ ɛ ɣ a d ɔ w lʲ a
есці	j ɛ sʲ t͡sʲ i
блакіт	b ɫ a kʲ i t
сінеча	sʲ i nʲ ɛ t͡ʂ a
калі-небудзь	k a lʲ i - nʲ ɛ b u d zʲ
танец	t a nʲ ɛ t͡s
адкінуць	a d kʲ i n u t͡sʲ
паніжэць	p a nʲ i ʐ ɛ t͡sʲ
аўтарухавік	a w t a r u x a vʲ i k
тканіна	t k a nʲ i n a
адтэрміноўка	a d t ɛ r mʲ i n ɔ w k a
выцвілы	v ɨ t͡sʲ vʲ i ɫ ɨ
цёмна-блакітны	t͡sʲ ɔ m n a - b ɫ a kʲ i t n ɨ
роў	r ɔ w
гвалціць	ɣ v a ɫ t͡sʲ i t͡sʲ
дагодлівы	d a ɣ ɔ d lʲ i v ɨ
заблішчаць	z a b lʲ i ʂ t͡ʂ a t͡sʲ
зламоўны	z ɫ a m ɔ w n ɨ
хлапчук	x ɫ a p t͡ʂ u k
растлумачыць	r a s t ɫ u m a t͡ʂ ɨ t͡sʲ
прамарнатравіць	p r a m a r n a t r a vʲ i t͡sʲ
скаржнік	s k a r ʐ nʲ i k
дамалоткі	d a m a ɫ ɔ t kʲ i
накаламуціць	n a k a ɫ a m u t͡sʲ i t͡sʲ
лапкі	ɫ a p kʲ i
мэндлік	m ɛ n d lʲ i k
перавыдаць	pʲ ɛ r a v ɨ d a t͡sʲ
прыгортваць	p r ɨ ɣ ɔ r t v a t͡sʲ
самаабслугоўванне	s a m a a b s ɫ u ɣ ɔ w v a nʲː ɛ
полымны	p ɔ ɫ ɨ m n ɨ
існасць	i s n a sʲ t͡sʲ
аксаміцісты	a k s a mʲ i t͡sʲ i s t ɨ
затлуміць	z a t ɫ u mʲ i t͡sʲ
скрыванне	s k r ɨ v a nʲː ɛ
хто	x t ɔ
перарабіць	pʲ ɛ r a r a bʲ i t͡sʲ
цмок	t͡s m ɔ k
зненавідзець	zʲ nʲ ɛ n a vʲ i d͡zʲ ɛ t͡sʲ
уцяць	u t͡sʲ a t͡sʲ
убудаваць	u b u d a v a t͡sʲ
велічны	vʲ ɛ lʲ i t͡ʂ n ɨ
макоўнік	m a k ɔ w nʲ i k
прыпеўкі	p r ɨ pʲ ɛ w kʲ i
пераплот	pʲ ɛ r a p ɫ ɔ t
авіяпрамысловасць	a vʲ i j a p r a m ɨ s ɫ ɔ v a sʲ t͡sʲ
сястра	sʲ a s t r a
вялікасны	vʲ a lʲ i k a s n ɨ
цар	t͡s a r
гарачкапаніжальны	ɣ a r a t͡ʂ k a p a nʲ i ʐ a lʲ n ɨ
макулінка	m a k u lʲ i n k a
напрасткі	n a p r a s t kʲ i
супакой	s u p a k ɔ j
бруіцца	b r u j i t͡sː a
увасабленне	u v a s a b lʲ ɛ nʲː ɛ
спадабацца	s p a d a b a t͡sː a
узрушыць	u z r u ʂ ɨ t͡sʲ
даўжэзны	d a w ʐ ɛ z n ɨ
прыламаць	p r ɨ ɫ a m a t͡sʲ
пацешыць	p a t͡sʲ ɛ ʂ ɨ t͡sʲ
пахіліць	p a xʲ i lʲ i t͡sʲ
разлогі	r a z ɫ ɔ ɣʲ i
хай	x a j
уразлівы	u r a zʲ lʲ i v ɨ
парасцярэбліваць	p a r a sʲ t͡sʲ a r ɛ b lʲ i v a t͡sʲ
хрысціць	x r ɨ sʲ t͡sʲ i t͡sʲ
глуміць	ɣ ɫ u mʲ i t͡sʲ
пашаляваць	p a ʂ a lʲ a v a t͡sʲ
убрукаваць	u b r u k a v a t͡sʲ
засеўкі	z a sʲ ɛ w kʲ i
першачарговы	pʲ ɛ r ʂ a t͡ʂ a r ɣ ɔ v ɨ
права	p r a v a
дрывотнік	d r ɨ v ɔ t nʲ i k
выціснуць	v ɨ t͡sʲ i s n u t͡sʲ
затуліць	z a t u lʲ i t͡sʲ
запэўніць	z a p ɛ w nʲ i t͡sʲ
назаўсёды	n a z a w sʲ ɔ d ɨ
штылет	ʂ t ɨ lʲ ɛ t
самадзейны	s a m a d͡zʲ ɛ j n ɨ
аржанішча	a r ʐ a nʲ i ʂ t͡ʂ a
ілгун	i ɫ ɣ u n
саскварыць	s a s k v a r ɨ t͡sʲ
узвялічыць	u zʲ vʲ a lʲ i t͡ʂ ɨ t͡sʲ
падчарэўе	p a t͡ʂː a r ɛ w j ɛ
падсітак	p a d sʲ i t a k
авечкагадоўля	a vʲ ɛ t͡ʂ k a ɣ a d ɔ w lʲ a
папаўдні	p a p a w d nʲ i
даўніна	d a w nʲ i n a
напаклёпнічаць	n a p a k lʲ ɔ p nʲ i t͡ʂ a t͡sʲ
даспяліць	d a sʲ pʲ a lʲ i t͡sʲ
паўцемра	p a w t͡sʲ ɛ m r a
ускатурхаць	u s k a t u r x a t͡sʲ
самадапамога	s a m a d a p a m ɔ ɣ a
пазакрэсліваць	p a z a k r ɛ sʲ lʲ i v a t͡sʲ
апазніцца	a p a zʲ nʲ i t͡sː a
гузік	ɣ u zʲ i k
асілак	a sʲ i ɫ a k
чмут	t͡ʂ m u t
прыцерушыць	p r ɨ t͡sʲ ɛ r u ʂ ɨ t͡sʲ
паімшыць	p a j i m ʂ ɨ t͡sʲ
падсаладзіць	p a d s a ɫ a d͡zʲ i t͡sʲ
кіўнуць	kʲ i w n u t͡sʲ
брыдкаслоўе	b r ɨ d k a s ɫ ɔ w j ɛ
папярэднічаць	p a pʲ a r ɛ d nʲ i t͡ʂ a t͡sʲ
дрыжыкі	d r ɨ ʐ ɨ kʲ i
слёзкі	sʲ lʲ ɔ z kʲ i
багаборніцтва	b a ɣ a b ɔ r nʲ i t͡s t v a
брусніца	b r u sʲ nʲ i t͡s a
нагаманіцца	n a ɣ a m a nʲ i t͡sː a
світальны	sʲ vʲ i t a lʲ n ɨ
уражваць	u r a ʐ v a t͡sʲ
спудлаваць	s p u d ɫ a v a t͡sʲ
спілаваць	sʲ pʲ i ɫ a v a t͡sʲ
пернік	pʲ ɛ r nʲ i k
пераветрыць	pʲ ɛ r a vʲ ɛ t r ɨ t͡sʲ
плазаваты	p ɫ a z a v a t ɨ
выцерусіць	v ɨ t͡sʲ ɛ r u sʲ i t͡sʲ
кнігавыдавецтва	k nʲ i ɣ a v ɨ d a vʲ ɛ t͡s t v a
тужлівы	t u ʐ lʲ i v ɨ
паглыбіць	p a ɣ ɫ ɨ bʲ i t͡sʲ
пазычальнік	p a z ɨ t͡ʂ a lʲ nʲ i k
загартоўка	z a ɣ a r t ɔ w k a
папрацаваць	p a p r a t͡s a v a t͡sʲ
утома	u t ɔ m a
своечасовы	s v ɔ j ɛ t͡ʂ a s ɔ v ɨ
напералік	n a pʲ ɛ r a lʲ i k
расшпіліць	r a s ʂ pʲ i lʲ i t͡sʲ
радзіна	r a d͡zʲ i n a
абліпнуць	a b lʲ i p n u t͡sʲ
вываліць	v ɨ v a lʲ i t͡sʲ
мытнік	m ɨ t nʲ i k
электрагадзіннік	ɛ lʲ ɛ k t r a ɣ a d͡zʲ i nʲː i k
абмежавальнік	a b mʲ ɛ ʐ a v a lʲ nʲ i k
марудзіць	m a r u d͡zʲ i t͡sʲ
паспагадаць	p a s p a ɣ a d a t͡sʲ
агідлівасць	a ɣʲ i d lʲ i v a sʲ t͡sʲ
адкласці	a d k ɫ a sʲ t͡sʲ i
сячкарня	sʲ a t͡ʂ k a r nʲ a
збіральнік	zʲ bʲ i r a lʲ nʲ i k
спадаць	s p a d a t͡sʲ
захінуць	z a xʲ i n u t͡sʲ
успасці	u s p a sʲ t͡sʲ i
далічыць	d a lʲ i t͡ʂ ɨ t͡sʲ
пафарбаваць	p a f a r b a v a t͡sʲ
уцяміць	u t͡sʲ a mʲ i t͡sʲ
прымайстраваць	p r ɨ m a j s t r a v a t͡sʲ
парасіцца	p a r a sʲ i t͡sː a
двухвокі	d v u x v ɔ kʲ i
зарабіць	z a r a bʲ i t͡sʲ
імкнуцца	i m k n u t͡sː a
зафарбоўка	z a f a r b ɔ w k a
радзіма	r a d͡zʲ i m a
загрудкі	z a ɣ r u d kʲ i
прамаўляць	p r a m a w lʲ a t͡sʲ
вымагальнік	v ɨ m a ɣ a lʲ nʲ i k
прапрацоўка	p r a p r a t͡s ɔ w k a
іглічны	i ɣ lʲ i t͡ʂ n ɨ
міжрэчча	mʲ i ʐ r ɛ t͡ʂː a
пазамацоўваць	p a z a m a t͡s ɔ w v a t͡sʲ
ржэўнік	r ʐ ɛ w nʲ i k
рынак	r ɨ n a k
нарыхтоўка	n a r ɨ x t ɔ w k a
апрацоўка	a p r a t͡s ɔ w k a
праштабноўка	p r a ʂ t a b n ɔ w k a
аціхнуць	a t͡sʲ i x n u t͡sʲ
назаўжды	n a z a w ʐ d ɨ
прапесціцца	p r a pʲ ɛ sʲ t͡sʲ i t͡sː a
ліхтар	lʲ i x t a r
прагусці	p r a ɣ u sʲ t͡sʲ i
калаўрот	k a ɫ a w r ɔ t
пячы	pʲ a t͡ʂ ɨ
пляснуць	p lʲ a s n u t͡sʲ
краязнаўства	k r a j a z n a w s t v a
палетуценіць	p a lʲ ɛ t u t͡sʲ ɛ nʲ i t͡sʲ
цагліна	t͡s a ɣ lʲ i n a
рызыка	r ɨ z ɨ k a
супакойлівы	s u p a k ɔ j lʲ i v ɨ
доўгачаканы	d ɔ w ɣ a t͡ʂ a k a n ɨ
разрабіць	r a z r a bʲ i t͡sʲ
неўрадлівы	nʲ ɛ w r a d lʲ i v ɨ
фатограф	f a t ɔ ɣ r a f
прарабіць	p r a r a bʲ i t͡sʲ
ператваральнік	pʲ ɛ r a t v a r a lʲ nʲ i k
памарнець	p a m a r nʲ ɛ t͡sʲ
каштоўнасць	k a ʂ t ɔ w n a sʲ t͡sʲ
персі	pʲ ɛ r sʲ i
прагнесці	p r a ɣ nʲ ɛ sʲ t͡sʲ i
чужы	t͡ʂ u ʐ ɨ
цыроўка	t͡s ɨ r ɔ w k a
камбітлушч	k a m bʲ i t ɫ u ʂ t͡ʂ
фонд	f ɔ n d
загрэбці	z a ɣ r ɛ b t͡sʲ i
аўтагаспадарка	a w t a ɣ a s p a d a r k a
прыспорыць	p r ɨ s p ɔ r ɨ t͡sʲ
паўкручваць	p a w k r u t͡ʂ v a t͡sʲ
літаратуразнавец	lʲ i t a r a t u r a z n a vʲ ɛ t͡s
самадастатковы	s a m a d a s t a t k ɔ v ɨ
шкоднік	ʂ k ɔ d nʲ i k
злічэнне	zʲ lʲ i t͡ʂ ɛ nʲː ɛ
каравіцца	k a r a vʲ i t͡sː a
пракрасціся	p r a k r a sʲ t͡sʲ i sʲ a
разлютаваць	r a zʲ lʲ u t a v a t͡sʲ
халява	x a lʲ a v a
болесуцішальны	b ɔ lʲ ɛ s u t͡sʲ i ʂ a lʲ n ɨ
пераплюхнуць	pʲ ɛ r a p lʲ u x n u t͡sʲ
бабінец	b a bʲ i nʲ ɛ t͡s
заўсёды	z a w sʲ ɔ d ɨ
пазасмечваць	p a z a sʲ mʲ ɛ t͡ʂ v a t͡sʲ
выцверазіць	v ɨ t͡sʲ vʲ ɛ r a zʲ i t͡sʲ
удзьмухнуць	u d zʲ m u x n u t͡sʲ
свабодны	s v a b ɔ d n ɨ
пахрысціць	p a x r ɨ sʲ t͡sʲ i t͡sʲ
удваіх	u d v a j i x
рэдукаваць	r ɛ d u k a v a t͡sʲ
агіда	a ɣʲ i d a
цікавасць	t͡sʲ i k a v a sʲ t͡sʲ
паўпаварота	p a w p a v a r ɔ t a
кемлівы	kʲ ɛ m lʲ i v ɨ
дзік	d͡zʲ i k
святлопранікальны	sʲ vʲ a t ɫ ɔ p r a nʲ i k a lʲ n ɨ
папацёмку	p a p a t͡sʲ ɔ m k u
разгрэбці	r a z ɣ r ɛ b t͡sʲ i
ружоўнік	r u ʐ ɔ w nʲ i k
панаглядаць	p a n a ɣ lʲ a d a t͡sʲ
спажывальнік	s p a ʐ ɨ v a lʲ nʲ i k
свіран	sʲ vʲ i r a n
нагарэзнічаць	n a ɣ a r ɛ zʲ nʲ i t͡ʂ a t͡sʲ
упрыгожанне	u p r ɨ ɣ ɔ ʐ a nʲː ɛ
змясіць	zʲ mʲ a sʲ i t͡sʲ
насельнік	n a sʲ ɛ lʲ nʲ i k
скобля	s k ɔ b lʲ a
неўміручы	nʲ ɛ w mʲ i r u t͡ʂ ɨ
ліхадзей	lʲ i x a d͡zʲ ɛ j
паджаўціць	p a d ʐ a w t͡sʲ i t͡sʲ
парад	p a r a d
сямігодка	sʲ a mʲ i ɣ ɔ d k a
асобнік	a s ɔ b nʲ i k
пакаёўка	p a k a j ɔ w k a
жаўцяк	ʐ a w t͡sʲ a k
шыкоўны	ʂ ɨ k ɔ w n ɨ
уславіць	u s ɫ a vʲ i t͡sʲ
перагартаць	pʲ ɛ r a ɣ a r t a t͡sʲ
перакладны	pʲ ɛ r a k ɫ a d n ɨ
цверазіць	t͡sʲ vʲ ɛ r a zʲ i t͡sʲ
жаўтатвары	ʐ a w t a t v a r ɨ
чаляднік	t͡ʂ a lʲ a d nʲ i k
паўсюдны	p a w sʲ u d n ɨ
вучнёўства	v u t͡ʂ nʲ ɔ w s t v a
дзівак	d͡zʲ i v a k
цемрашальства	t͡sʲ ɛ m r a ʂ a lʲ s t v a
хварэць	x v a r ɛ t͡sʲ
выпрасоўка	v ɨ p r a s ɔ w k a
лецішча	lʲ ɛ t͡sʲ i ʂ t͡ʂ a
навальніца	n a v a lʲ nʲ i t͡s a
адпрацоўка	a d p r a t͡s ɔ w k a
ліхадзейства	lʲ i x a d͡zʲ ɛ j s t v a
зняпраўдзіць	zʲ nʲ a p r a w d͡zʲ i t͡sʲ
віраваць	vʲ i r a v a t͡sʲ
абакрасці	a b a k r a sʲ t͡sʲ i
павалтузіць	p a v a ɫ t u zʲ i t͡sʲ
абваліць	a b v a lʲ i t͡sʲ
цішэць	t͡sʲ i ʂ ɛ t͡sʲ
даўгаваты	d a w ɣ a v a t ɨ
чысцец	t͡ʂ ɨ sʲ t͡sʲ ɛ t͡s
чашчыня	t͡ʂ a ʂ t͡ʂ ɨ nʲ a
засцерагальнік	z a sʲ t͡sʲ ɛ r a ɣ a lʲ nʲ i k
сысці	s ɨ sʲ t͡sʲ i
стваральнік	s t v a r a lʲ nʲ i k
пашарпаць	p a ʂ a r p a t͡sʲ
доўгачаранковы	d ɔ w ɣ a t͡ʂ a r a n k ɔ v ɨ
перакуліць	pʲ ɛ r a k u lʲ i t͡sʲ
усцягнуць	u sʲ t͡sʲ a ɣ n u t͡sʲ
парушынка	p a r u ʂ ɨ n k a
скардзіцца	s k a r d͡zʲ i t͡sː a
самалёт	s a m a lʲ ɔ t
лічыць	lʲ i t͡ʂ ɨ t͡sʲ
прызначэнне	p r ɨ z n a t͡ʂ ɛ nʲː ɛ
завіраваць	z a vʲ i r a v a t͡sʲ
залётнік	z a lʲ ɔ t nʲ i k
павыкрэсліваць	p a v ɨ k r ɛ sʲ lʲ i v a t͡sʲ
паўсядзённы	p a w sʲ a d͡zʲ ɔ nː ɨ
пачухаць	p a t͡ʂ u x a t͡sʲ
напаўхмызняк	n a p a w x m ɨ zʲ nʲ a k
сутарэнне	s u t a r ɛ nʲː ɛ
прысіліць	p r ɨ sʲ i lʲ i t͡sʲ
заняпасці	z a nʲ a p a sʲ t͡sʲ i
правапіс	p r a v a pʲ i s
мараплаўства	m a r a p ɫ a w s t v a
перапакутаваць	pʲ ɛ r a p a k u t a v a t͡sʲ
высокашаноўны	v ɨ s ɔ k a ʂ a n ɔ w n ɨ
танны	t a nː ɨ
вялікасць	vʲ a lʲ i k a sʲ t͡sʲ
выкаўзаць	v ɨ k a w z a t͡sʲ
абплысці	a b p ɫ ɨ sʲ t͡sʲ i
збожжаўборка	z b ɔ ʐ ʐ a w b ɔ r k a
пырснуць	p ɨ r s n u t͡sʲ
убінтаваць	u bʲ i n t a v a t͡sʲ
пааблямоўваць	p a a b lʲ a m ɔ w v a t͡sʲ
залагодзіць	z a ɫ a ɣ ɔ d͡zʲ i t͡sʲ
жаўлак	ʐ a w ɫ a k
касільна	k a sʲ i lʲ n a
сталіць	s t a lʲ i t͡sʲ
стварыць	s t v a r ɨ t͡sʲ
давэндзіць	d a v ɛ n d͡zʲ i t͡sʲ
абагачальнік	a b a ɣ a t͡ʂ a lʲ nʲ i k
прыклець	p r ɨ k lʲ ɛ t͡sʲ
чысціня	t͡ʂ ɨ sʲ t͡sʲ i nʲ a
пранікальны	p r a nʲ i k a lʲ n ɨ
абцерабіць	a b t͡sʲ ɛ r a bʲ i t͡sʲ
хрысціны	x r ɨ sʲ t͡sʲ i n ɨ
шпіталь	ʂ pʲ i t a lʲ
пяцігадовы	pʲ a t͡sʲ i ɣ a d ɔ v ɨ
ніштаваты	nʲ i ʂ t a v a t ɨ
паціху	p a t͡sʲ i x u
хаўрус	x a w r u s
дажджоўнік	d a ʐ d ʐ ɔ w nʲ i k
хмызняк	x m ɨ zʲ nʲ a k
занепакоіць	z a nʲ ɛ p a k ɔ j i t͡sʲ
сартавальнік	s a r t a v a lʲ nʲ i k
аўтабудаўнік	a w t a b u d a w nʲ i k
папражыць	p a p r a ʐ ɨ t͡sʲ
тлусцець	t ɫ u sʲ t͡sʲ ɛ t͡sʲ
сям-там	sʲ a m - t a m
злучнік	z ɫ u t͡ʂ nʲ i k
шуфляда	ʂ u f lʲ a d a
юрлівец	j u r lʲ i vʲ ɛ t͡s
карэнішча	k a r ɛ nʲ i ʂ t͡ʂ a
скрануць	s k r a n u t͡sʲ
фотааматар	f ɔ t a a m a t a r
прыпільнаваць	p r ɨ pʲ i lʲ n a v a t͡sʲ
прызапасіць	p r ɨ z a p a sʲ i t͡sʲ
суцяшальны	s u t͡sʲ a ʂ a lʲ n ɨ
лікавы	lʲ i k a v ɨ
жывёлагадоўля	ʐ ɨ vʲ ɔ ɫ a ɣ a d ɔ w lʲ a
прадпрымальнік	p r a d p r ɨ m a lʲ nʲ i k
фіранка	fʲ i r a n k a
хтосьці	x t ɔ sʲ t͡sʲ i
нацянькі	n a t͡sʲ a nʲ kʲ i
паўкварты	p a w k v a r t ɨ
шоргат	ʂ ɔ r ɣ a t
выкласці	v ɨ k ɫ a sʲ t͡sʲ i
расшрубаваць	r a s ʂ r u b a v a t͡sʲ
існаваць	i s n a v a t͡sʲ
разгортка	r a z ɣ ɔ r t k a
прыжоўкнуць	p r ɨ ʐ ɔ w k n u t͡sʲ
здрадзіць	z d r a d͡zʲ i t͡sʲ
крэўны	k r ɛ w n ɨ
выяўленчы	v ɨ j a w lʲ ɛ n t͡ʂ ɨ
грэбці	ɣ r ɛ b t͡sʲ i
пералічыць	pʲ ɛ r a lʲ i t͡ʂ ɨ t͡sʲ
лінеіць	lʲ i nʲ ɛ j i t͡sʲ
покрыва	p ɔ k r ɨ v a
вадаплаўны	v a d a p ɫ a w n ɨ
селядцоўка	sʲ ɛ lʲ a d t͡s ɔ w k a
падвоіць	p a d v ɔ j i t͡sʲ
пераскародзіць	pʲ ɛ r a s k a r ɔ d͡zʲ i t͡sʲ
ацеслівы	a t͡sʲ ɛ sʲ lʲ i v ɨ
навысвідроўваць	n a v ɨ sʲ vʲ i d r ɔ w v a t͡sʲ
фарбавальнік	f a r b a v a lʲ nʲ i k
сядзець	sʲ a d͡zʲ ɛ t͡sʲ
пабрудзіць	p a b r u d͡zʲ i t͡sʲ
сялянства	sʲ a lʲ a n s t v a
мытніца	m ɨ t nʲ i t͡s a
знітаваць	zʲ nʲ i t a v a t͡sʲ
раскудлаціць	r a s k u d ɫ a t͡sʲ i t͡sʲ
звільгатнець	zʲ vʲ i lʲ ɣ a t nʲ ɛ t͡sʲ
грачанік	ɣ r a t͡ʂ a nʲ i k
разнадумнасць	r a z n a d u m n a sʲ t͡sʲ
пахіснуць	p a xʲ i s n u t͡sʲ
перыяд	pʲ ɛ r ɨ j a d
узбоч	u z b ɔ t͡ʂ
урэчнік	u r ɛ t͡ʂ nʲ i k
падлоўчы	p a d ɫ ɔ w t͡ʂ ɨ
холад	x ɔ ɫ a d
зносіны	z n ɔ sʲ i n ɨ
настольнік	n a s t ɔ lʲ nʲ i k
пахвастаць	p a x v a s t a t͡sʲ
расхваляваць	r a s x v a lʲ a v a t͡sʲ
устрымацца	u s t r ɨ m a t͡sː a
пошук	p ɔ ʂ u k
хвалісты	x v a lʲ i s t ɨ
маўклівы	m a w k lʲ i v ɨ
пакрыўдзіць	p a k r ɨ w d͡zʲ i t͡sʲ
загугнявіць	z a ɣ u ɣ nʲ a vʲ i t͡sʲ
сёлетні	sʲ ɔ lʲ ɛ t nʲ i
дваісты	d v a j i s t ɨ
суцяшальнік	s u t͡sʲ a ʂ a lʲ nʲ i k
суіскальнік	s u j i s k a lʲ nʲ i k
тавар	t a v a r
устаноўчы	u s t a n ɔ w t͡ʂ ɨ
наўздагон	n a w z d a ɣ ɔ n
бурачнішча	b u r a t͡ʂ nʲ i ʂ t͡ʂ a
прымусам	p r ɨ m u s a m
скарынка	s k a r ɨ n k a
змоўленасць	z m ɔ w lʲ ɛ n a sʲ t͡sʲ
імховы	i m x ɔ v ɨ
вымяральнік	v ɨ mʲ a r a lʲ nʲ i k
палахлівы	p a ɫ a x lʲ i v ɨ
залічыць	z a lʲ i t͡ʂ ɨ t͡sʲ
дрэваапрацоўка	d r ɛ v a a p r a t͡s ɔ w k a
пяціразовы	pʲ a t͡sʲ i r a z ɔ v ɨ
прасцюткі	p r a sʲ t͡sʲ u t kʲ i
ужо	u ʐ ɔ
закоўзаць	z a k ɔ w z a t͡sʲ
грашоўны	ɣ r a ʂ ɔ w n ɨ
хабарніцтва	x a b a r nʲ i t͡s t v a
грукатлівы	ɣ r u k a t lʲ i v ɨ
храбусценне	x r a b u sʲ t͡sʲ ɛ nʲː ɛ
прызвычаіць	p r ɨ z v ɨ t͡ʂ a j i t͡sʲ
дарабіць	d a r a bʲ i t͡sʲ
падзарабіць	p a d͡z a r a bʲ i t͡sʲ
закід	z a kʲ i d
пашпацыраваць	p a ʂ p a t͡s ɨ r a v a t͡sʲ
радца	r a d t͡s a
кровазліццё	k r ɔ v a zʲ lʲ i t͡sʲː ɔ
спорны	s p ɔ r n ɨ
паўжартам	p a w ʐ a r t a m
адклікаць	a d k lʲ i k a t͡sʲ
прыяцель	p r ɨ j a t͡sʲ ɛ lʲ
тэлеглядач	t ɛ lʲ ɛ ɣ lʲ a d a t͡ʂ
вірлавокі	vʲ i r ɫ a v ɔ kʲ i
клённік	k lʲ ɔ nʲː i k
таваразнаўца	t a v a r a z n a w t͡s a
святлафор	sʲ vʲ a t ɫ a f ɔ r
кара	k a r a
распалка	r a s p a ɫ k a
аканіца	a k a nʲ i t͡s a
падфарбоўка	p a d f a r b ɔ w k a
спружыноўка	s p r u ʐ ɨ n ɔ w k a
падпільнаваць	p a d pʲ i lʲ n a v a t͡sʲ
перасцерагчы	pʲ ɛ r a sʲ t͡sʲ ɛ r a ɣ t͡ʂ ɨ
перашараваць	pʲ ɛ r a ʂ a r a v a t͡sʲ
пярэступ	pʲ a r ɛ s t u p
зіхацець	zʲ i x a t͡sʲ ɛ t͡sʲ
труціць	t r u t͡sʲ i t͡sʲ
скруха	s k r u x a
дзесьці	d͡zʲ ɛ sʲ t͡sʲ i
адгадзіць	a d ɣ a d͡zʲ i t͡sʲ
разлічыць	r a zʲ lʲ i t͡ʂ ɨ t͡sʲ
форма	f ɔ r m a
лазавік	ɫ a z a vʲ i k
распрануць	r a s p r a n u t͡sʲ
імавернасць	i m a vʲ ɛ r n a sʲ t͡sʲ
пошчак	p ɔ ʂ t͡ʂ a k
націск	n a t͡sʲ i s k
адзінота	a d͡zʲ i n ɔ t a
унікнуць	u nʲ i k n u t͡sʲ
упаліць	u p a lʲ i t͡sʲ
дрыгатлівы	d r ɨ ɣ a t lʲ i v ɨ
замілаванасць	z a mʲ i ɫ a v a n a sʲ t͡sʲ
пярэварацень	pʲ a r ɛ v a r a t͡sʲ ɛ nʲ
ёкат	j ɔ k a t
кудзелісты	k u d͡zʲ ɛ lʲ i s t ɨ
счарніць	s t͡ʂ a r nʲ i t͡sʲ
розгалас	r ɔ z ɣ a ɫ a s
безнаяўны	bʲ ɛ z n a j a w n ɨ
пункт	p u n k t
зыркі	z ɨ r kʲ i
пляткар	p lʲ a t k a r
зазіхацець	z a zʲ i x a t͡sʲ ɛ t͡sʲ
знаходлівы	z n a x ɔ d lʲ i v ɨ
аднавіць	a d n a vʲ i t͡sʲ
цукарніца	t͡s u k a r nʲ i t͡s a
бабовішча	b a b ɔ vʲ i ʂ t͡ʂ a
шал	ʂ a ɫ
пасрэдны	p a s r ɛ d n ɨ
грубіянства	ɣ r u bʲ i j a n s t v a
адскрэбці	a d s k r ɛ b t͡sʲ i
пякучы	pʲ a k u t͡ʂ ɨ
сявенька	sʲ a vʲ ɛ nʲ k a
снедаць	sʲ nʲ ɛ d a t͡sʲ
рашчыніць	r a ʂ t͡ʂ ɨ nʲ i t͡sʲ
возніцтва	v ɔ zʲ nʲ i t͡s t v a
хлеб	x lʲ ɛ b
жаўцянка	ʐ a w t͡sʲ a n k a
паўхутваць	p a w x u t v a t͡sʲ
захавальнік	z a x a v a lʲ nʲ i k
усцяж	u sʲ t͡sʲ a ʐ
стрымаць	s t r ɨ m a t͡sʲ
мітусіцца	mʲ i t u sʲ i t͡sː a
барліна	b a r lʲ i n a
прыгодніцкі	p r ɨ ɣ ɔ d nʲ i t͡s kʲ i
ёмісты	j ɔ mʲ i s t ɨ
практыка	p r a k t ɨ k a
туліць	t u lʲ i t͡sʲ
разнервавацца	r a zʲ nʲ ɛ r v a v a t͡sː a
знечуліць	zʲ nʲ ɛ t͡ʂ u lʲ i t͡sʲ
цалік	t͡s a lʲ i k
ухвала	u x v a ɫ a
дробнакаліберны	d r ɔ b n a k a lʲ i bʲ ɛ r n ɨ
прымураваць	p r ɨ m u r a v a t͡sʲ
сварка	s v a r k a
высокачуллівы	v ɨ s ɔ k a t͡ʂ u lʲ lʲ ʲ i v ɨ
панарабляць	p a n a r a b lʲ a t͡sʲ
згаіць	z ɣ a j i t͡sʲ
двоеўладдзе	d v ɔ j ɛ w ɫ a d͡zʲː ɛ
рубам	r u b a m
цэлы	t͡s ɛ ɫ ɨ
вяргіня	vʲ a r ɣʲ i nʲ a
ператрываць	pʲ ɛ r a t r ɨ v a t͡sʲ
расплывісты	r a s p ɫ ɨ vʲ i s t ɨ
світанак	sʲ vʲ i t a n a k
васьміразовы	v a sʲ mʲ i r a z ɔ v ɨ
дагрэбці	d a ɣ r ɛ b t͡sʲ i
злітак	zʲ lʲ i t a k
прыклеп	p r ɨ k lʲ ɛ p
падліковы	p a d lʲ i k ɔ v ɨ
удзяўбці	u d͡zʲ a w b t͡sʲ i
грамніцы	ɣ r a m nʲ i t͡s ɨ
сяголетні	sʲ a ɣ ɔ lʲ ɛ t nʲ i
зніякавець	zʲ nʲ i j a k a vʲ ɛ t͡sʲ
угрунтаванасць	u ɣ r u n t a v a n a sʲ t͡sʲ
палетуцець	p a lʲ ɛ t u t͡sʲ ɛ t͡sʲ
узбудлівасць	u z b u d lʲ i v a sʲ t͡sʲ
прыдашак	p r ɨ d a ʂ a k
зазірнуць	z a zʲ i r n u t͡sʲ
угаіць	u ɣ a j i t͡sʲ
адзімак	a d͡zʲ i m a k
жаўталісце	ʐ a w t a lʲ i sʲ t͡sʲ ɛ
сляпіца	sʲ lʲ a pʲ i t͡s a
знаравіцца	z n a r a vʲ i t͡sː a
угразнуць	u ɣ r a z n u t͡sʲ
згубіць	z ɣ u bʲ i t͡sʲ
падакідваць	p a d a kʲ i d v a t͡sʲ
чысты	t͡ʂ ɨ s t ɨ
двухрадкоўе	d v u x r a d k ɔ w j ɛ
полудзень	p ɔ ɫ u d͡zʲ ɛ nʲ
гарэзнічаць	ɣ a r ɛ zʲ nʲ i t͡ʂ a t͡sʲ
прасмаліць	p r a s m a lʲ i t͡sʲ
усе	u sʲ ɛ
брудзіць	b r u d͡zʲ i t͡sʲ
парушальнік	p a r u ʂ a lʲ nʲ i k
бліскаўка	b lʲ i s k a w k a
дамовіцца	d a m ɔ vʲ i t͡sː a
даціснуць	d a t͡sʲ i s n u t͡sʲ
вогнеўстойлівы	v ɔ ɣ nʲ ɛ w s t ɔ j lʲ i v ɨ
торбачнік	t ɔ r b a t͡ʂ nʲ i k
вір	vʲ i r
перапона	pʲ ɛ r a p ɔ n a
мсцівец	m sʲ t͡sʲ i vʲ ɛ t͡s
заходні	z a x ɔ d nʲ i
саладуха	s a ɫ a d u x a
астойлівасць	a s t ɔ j lʲ i v a sʲ t͡sʲ
назахопліваць	n a z a x ɔ p lʲ i v a t͡sʲ
ці	t͡sʲ i
пакрывец	p a k r ɨ vʲ ɛ t͡s
богашукальнік	b ɔ ɣ a ʂ u k a lʲ nʲ i k
перацяць	pʲ ɛ r a t͡sʲ a t͡sʲ
забрудзіць	z a b r u d͡zʲ i t͡sʲ
карункі	k a r u n kʲ i
малаімаверны	m a ɫ a j i m a vʲ ɛ r n ɨ
гадавіна	ɣ a d a vʲ i n a
кароткатэрміновы	k a r ɔ t k a t ɛ r mʲ i n ɔ v ɨ
кажушнік	k a ʐ u ʂ nʲ i k
пераасэнсаваць	pʲ ɛ r a a s ɛ n s a v a t͡sʲ
рабіць	r a bʲ i t͡sʲ
аўсянік	a w sʲ a nʲ i k
дзірван	d͡zʲ i r v a n
досвітак	d ɔ sʲ vʲ i t a k
разгледзець	r a z ɣ lʲ ɛ d͡zʲ ɛ t͡sʲ
процівага	p r ɔ t͡sʲ i v a ɣ a
прыладдзе	p r ɨ ɫ a d͡zʲː ɛ
упокат	u p ɔ k a t
скавароднік	s k a v a r ɔ d nʲ i k
кудлаціць	k u d ɫ a t͡sʲ i t͡sʲ
засвоіць	z a s v ɔ j i t͡sʲ
выканаўца	v ɨ k a n a w t͡s a
кілішак	kʲ i lʲ i ʂ a k
перавыхаваць	pʲ ɛ r a v ɨ x a v a t͡sʲ
абліць	a b lʲ i t͡sʲ
птушкагадоўля	p t u ʂ k a ɣ a d ɔ w lʲ a
прагортваць	p r a ɣ ɔ r t v a t͡sʲ
ужывальны	u ʐ ɨ v a lʲ n ɨ
параспуджваць	p a r a s p u d ʐ v a t͡sʲ
послух	p ɔ s ɫ u x
шпак	ʂ p a k
схільны	s xʲ i lʲ n ɨ
пратрымаць	p r a t r ɨ m a t͡sʲ
шчыліна	ʂ t͡ʂ ɨ lʲ i n a
падгалісты	p a d ɣ a lʲ i s t ɨ
перавандраваць	pʲ ɛ r a v a n d r a v a t͡sʲ
паадбудоўваць	p a a d b u d ɔ w v a t͡sʲ
паўплываць	p a w p ɫ ɨ v a t͡sʲ
поле	p ɔ lʲ ɛ
выканальніцтва	v ɨ k a n a lʲ nʲ i t͡s t v a
хацішча	x a t͡sʲ i ʂ t͡ʂ a
вершапісанне	vʲ ɛ r ʂ a pʲ i s a nʲː ɛ
спараваць	s p a r a v a t͡sʲ
светапогляд	sʲ vʲ ɛ t a p ɔ ɣ lʲ a d
паваротлівы	p a v a r ɔ t lʲ i v ɨ
вільгаць	vʲ i lʲ ɣ a t͡sʲ
бруісты	b r u j i s t ɨ
даверлівы	d a vʲ ɛ r lʲ i v ɨ
пястуха	pʲ a s t u x a
вадасховішча	v a d a s x ɔ vʲ i ʂ t͡ʂ a
прыдзірлівы	p r ɨ d͡zʲ i r lʲ i v ɨ
перакасаваць	pʲ ɛ r a k a s a v a t͡sʲ
па-прадажніцку	p a - p r a d a ʐ nʲ i t͡s k u
шараваты	ʂ a r a v a t ɨ
запесціць	z a pʲ ɛ sʲ t͡sʲ i t͡sʲ
застаўка	z a s t a w k a
паўкола	p a w k ɔ ɫ a
росквіт	r ɔ s k vʲ i t
пазіхацець	p a zʲ i x a t͡sʲ ɛ t͡sʲ
страціць	s t r a t͡sʲ i t͡sʲ
заўладаць	z a w ɫ a d a t͡sʲ
трапіць	t r a pʲ i t͡sʲ
імша	i m ʂ a
зрывісты	z r ɨ vʲ i s t ɨ
разважлівы	r a z v a ʐ lʲ i v ɨ
насвідраваць	n a sʲ vʲ i d r a v a t͡sʲ
разгалісты	r a z ɣ a lʲ i s t ɨ
лісцвянік	lʲ i sʲ t͡sʲ vʲ a nʲ i k
пашастаць	p a ʂ a s t a t͡sʲ
залозніца	z a ɫ ɔ zʲ nʲ i t͡s a
ліпень	lʲ i pʲ ɛ nʲ
перапрэгчы	pʲ ɛ r a p r ɛ ɣ t͡ʂ ɨ
дакоскі	d a k ɔ s kʲ i
дыхавіца	d ɨ x a vʲ i t͡s a
уштурхнуць	u ʂ t u r x n u t͡sʲ
прытрызніць	p r ɨ t r ɨ zʲ nʲ i t͡sʲ
імгліць	i m ɣ lʲ i t͡sʲ
шрубаваць	ʂ r u b a v a t͡sʲ
параскалупваць	p a r a s k a ɫ u p v a t͡sʲ
нашыйнік	n a ʂ ɨ j nʲ i k
спухнуць	s p u x n u t͡sʲ
лічылка	lʲ i t͡ʂ ɨ ɫ k a
вынішчыць	v ɨ nʲ i ʂ t͡ʂ ɨ t͡sʲ
рэшткі	r ɛ ʂ t kʲ i
смерць	sʲ mʲ ɛ r t͡sʲ
пазахінаць	p a z a xʲ i n a t͡sʲ
першаўзор	pʲ ɛ r ʂ a w z ɔ r
файл	f a j ɫ
зірнуць	zʲ i r n u t͡sʲ
півоня	pʲ i v ɔ nʲ a
сетка	sʲ ɛ t k a
індычка	i n d ɨ t͡ʂ k a
узнагародзіць	u z n a ɣ a r ɔ d͡zʲ i t͡sʲ
воплескі	v ɔ p lʲ ɛ s kʲ i
стуканіна	s t u k a nʲ i n a
уджгнуць	u d ʐ ɣ n u t͡sʲ
паўкладаць	p a w k ɫ a d a t͡sʲ
датаўчы	d a t a w t͡ʂ ɨ
музеязнаўства	m u zʲ ɛ j a z n a w s t v a
здраднік	z d r a d nʲ i k
абразіць	a b r a zʲ i t͡sʲ
завітаць	z a vʲ i t a t͡sʲ
пярэрва	pʲ a r ɛ r v a
баечнік	b a j ɛ t͡ʂ nʲ i k
заскародзіць	z a s k a r ɔ d͡zʲ i t͡sʲ
жывасілам	ʐ ɨ v a sʲ i ɫ a m
перахапіць	pʲ ɛ r a x a pʲ i t͡sʲ
пасрэдніцтва	p a s r ɛ d nʲ i t͡s t v a
фастрыгаваць	f a s t r ɨ ɣ a v a t͡sʲ
бульбянік	b u lʲ bʲ a nʲ i k
паскародзіць	p a s k a r ɔ d͡zʲ i t͡sʲ
рыштаванне	r ɨ ʂ t a v a nʲː ɛ
паўмалпа	p a w m a ɫ p a
замгліць	z a m ɣ lʲ i t͡sʲ
разараць	r a z a r a t͡sʲ
пшанічнішча	p ʂ a nʲ i t͡ʂ nʲ i ʂ t͡ʂ a
паабгаблёўваць	p a a b ɣ a b lʲ ɔ w v a t͡sʲ
дзейнік	d͡zʲ ɛ j nʲ i k
самохаць	s a m ɔ x a t͡sʲ
самаздаволены	s a m a z d a v ɔ lʲ ɛ n ɨ
лічнік	lʲ i t͡ʂ nʲ i k
птушніца	p t u ʂ nʲ i t͡s a
брыфінг	b r ɨ fʲ i n ɣ
распрэгчы	r a s p r ɛ ɣ t͡ʂ ɨ
чынны	t͡ʂ ɨ nː ɨ
спрат	s p r a t
параніцца	p a r a nʲ i t͡sː a
унадзіцца	u n a d͡zʲ i t͡sː a
сутокі	s u t ɔ kʲ i
пераніцаваць	pʲ ɛ r a nʲ i t͡s a v a t͡sʲ
літаваць	lʲ i t a v a t͡sʲ
спажыва	s p a ʐ ɨ v a
паразграбаць	p a r a z ɣ r a b a t͡sʲ
іншадумства	i n ʂ a d u m s t v a
ашчадлівасць	a ʂ t͡ʂ a d lʲ i v a sʲ t͡sʲ
выславіць	v ɨ s ɫ a vʲ i t͡sʲ
пасярэдзіне	p a sʲ a r ɛ d͡zʲ i nʲ ɛ
помнік	p ɔ m nʲ i k
зацвердзіць	z a t͡sʲ vʲ ɛ r d͡zʲ i t͡sʲ
выгінасты	v ɨ ɣʲ i n a s t ɨ
сховішча	s x ɔ vʲ i ʂ t͡ʂ a
ухілісты	u xʲ i lʲ i s t ɨ
парадковы	p a r a d k ɔ v ɨ
няпэўны	nʲ a p ɛ w n ɨ
узлегчы	u zʲ lʲ ɛ ɣ t͡ʂ ɨ
прысунуць	p r ɨ s u n u t͡sʲ
санапрацоўка	s a n a p r a t͡s ɔ w k a
цвіль	t͡sʲ vʲ i lʲ
звабіць	z v a bʲ i t͡sʲ
гадзіна	ɣ a d͡zʲ i n a
залітаваць	z a lʲ i t a v a t͡sʲ
прыназоўнік	p r ɨ n a z ɔ w nʲ i k
мнагалікі	m n a ɣ a lʲ i kʲ i
скід	s kʲ i d
саракоўка	s a r a k ɔ w k a
размаляваць	r a z m a lʲ a v a t͡sʲ
скакаць	s k a k a t͡sʲ
пацяробкі	p a t͡sʲ a r ɔ b kʲ i
шыцік	ʂ ɨ t͡sʲ i k
падгаліць	p a d ɣ a lʲ i t͡sʲ
брахлівы	b r a x lʲ i v ɨ
дзеепрыметнік	d͡zʲ ɛ j ɛ p r ɨ mʲ ɛ t nʲ i k
лекі	lʲ ɛ kʲ i
добраўпарадкаваны	d ɔ b r a w p a r a d k a v a n ɨ
лупіць	ɫ u pʲ i t͡sʲ
поўня	p ɔ w nʲ a
празіхацець	p r a zʲ i x a t͡sʲ ɛ t͡sʲ
павылічваць	p a v ɨ lʲ i t͡ʂ v a t͡sʲ
перацерці	pʲ ɛ r a t͡sʲ ɛ r t͡sʲ i
дзевяціразовы	d͡zʲ ɛ vʲ a t͡sʲ i r a z ɔ v ɨ
удубець	u d u bʲ ɛ t͡sʲ
захапіць	z a x a pʲ i t͡sʲ
загнюсіць	z a ɣ nʲ u sʲ i t͡sʲ
пераскрэбці	pʲ ɛ r a s k r ɛ b t͡sʲ i
вялікі	vʲ a lʲ i kʲ i
разбараніць	r a z b a r a nʲ i t͡sʲ
прамянець	p r a mʲ a nʲ ɛ t͡sʲ
памеркаваць	p a mʲ ɛ r k a v a t͡sʲ
скародзіць	s k a r ɔ d͡zʲ i t͡sʲ
піліпаўка	pʲ i lʲ i p a w k a
папрымацоўваць	p a p r ɨ m a t͡s ɔ w v a t͡sʲ
дазволіць	d a z v ɔ lʲ i t͡sʲ
закінуць	z a kʲ i n u t͡sʲ
зачырваніць	z a t͡ʂ ɨ r v a nʲ i t͡sʲ
удаваць	u d a v a t͡sʲ
размалёўка	r a z m a lʲ ɔ w k a
працаздольнасць	p r a t͡s a z d ɔ lʲ n a sʲ t͡sʲ
сніць	sʲ nʲ i t͡sʲ
зніжальны	zʲ nʲ i ʐ a lʲ n ɨ
кішэнь	kʲ i ʂ ɛ nʲ
прыкветак	p r ɨ k vʲ ɛ t a k
пасівераць	p a sʲ i vʲ ɛ r a t͡sʲ
запрыгоніць	z a p r ɨ ɣ ɔ nʲ i t͡sʲ
назіральнік	n a zʲ i r a lʲ nʲ i k
спялець	sʲ pʲ a lʲ ɛ t͡sʲ
праваблівы	p r a v a b lʲ i v ɨ
зганіць	z ɣ a nʲ i t͡sʲ
перабудаваць	pʲ ɛ r a b u d a v a t͡sʲ
нястраўнасць	nʲ a s t r a w n a sʲ t͡sʲ
практычны	p r a k t ɨ t͡ʂ n ɨ
заструменіць	z a s t r u mʲ ɛ nʲ i t͡sʲ
памазоліць	p a m a z ɔ lʲ i t͡sʲ
вынаходлівы	v ɨ n a x ɔ d lʲ i v ɨ
узважыць	u z v a ʐ ɨ t͡sʲ
газасховішча	ɣ a z a s x ɔ vʲ i ʂ t͡ʂ a
марнаслоўны	m a r n a s ɫ ɔ w n ɨ
спрацавацца	s p r a t͡s a v a t͡sː a
пужала	p u ʐ a ɫ a
літасцівы	lʲ i t a sʲ t͡sʲ i v ɨ
электралічыльнік	ɛ lʲ ɛ k t r a lʲ i t͡ʂ ɨ lʲ nʲ i k
узгадніць	u z ɣ a d nʲ i t͡sʲ
папацягаць	p a p a t͡sʲ a ɣ a t͡sʲ
расслізгаць	r a sʲː lʲ i z ɣ a t͡sʲ
нараіць	n a r a j i t͡sʲ
пан	p a n
парупіцца	p a r u pʲ i t͡sː a
даўгачасны	d a w ɣ a t͡ʂ a s n ɨ
справаздача	s p r a v a z d a t͡ʂ a
піск	pʲ i s k
распалавініць	r a s p a ɫ a vʲ i nʲ i t͡sʲ
іржа	i r ʐ a
зласлівы	z ɫ a sʲ lʲ i v ɨ
заўчасны	z a w t͡ʂ a s n ɨ
тарабаніць	t a r a b a nʲ i t͡sʲ
запаганіць	z a p a ɣ a nʲ i t͡sʲ
раззброіць	r a z z b r ɔ j i t͡sʲ
ліхвярства	lʲ i x vʲ a r s t v a
шпіталізацыя	ʂ pʲ i t a lʲ i z a t͡s ɨ j a
фашыст	f a ʂ ɨ s t
песціць	pʲ ɛ sʲ t͡sʲ i t͡sʲ
скідальнік	s kʲ i d a lʲ nʲ i k
прыпынішча	p r ɨ p ɨ nʲ i ʂ t͡ʂ a
цана	t͡s a n a
парухаць	p a r u x a t͡sʲ
понаж	p ɔ n a ʐ
паплечнік	p a p lʲ ɛ t͡ʂ nʲ i k
заяўнік	z a j a w nʲ i k
цурацца	t͡s u r a t͡sː a
развітацца	r a zʲ vʲ i t a t͡sː a
абліпка	a b lʲ i p k a
прамыслоўца	p r a m ɨ s ɫ ɔ w t͡s a
садзейнічаць	s a d͡zʲ ɛ j nʲ i t͡ʂ a t͡sʲ
разуменне	r a z u mʲ ɛ nʲː ɛ
раскатурхаць	r a s k a t u r x a t͡sʲ
абрасіць	a b r a sʲ i t͡sʲ
шчыгрын	ʂ t͡ʂ ɨ ɣ r ɨ n
прымеціць	p r ɨ mʲ ɛ t͡sʲ i t͡sʲ
упоцемку	u p ɔ t͡sʲ ɛ m k u
аздобіць	a z d ɔ bʲ i t͡sʲ
паскубці	p a s k u b t͡sʲ i
раздрабніць	r a z d r a b nʲ i t͡sʲ
крываўнік	k r ɨ v a w nʲ i k
жаласлівы	ʐ a ɫ a sʲ lʲ i v ɨ
яліна	j a lʲ i n a
ускалупіць	u s k a ɫ u pʲ i t͡sʲ
цягучка	t͡sʲ a ɣ u t͡ʂ k a
пярэсты	pʲ a r ɛ s t ɨ
скарабаціць	s k a r a b a t͡sʲ i t͡sʲ
умовіцца	u m ɔ vʲ i t͡sː a
смактаць	s m a k t a t͡sʲ
памарыць	p a m a r ɨ t͡sʲ
цабэрак	t͡s a b ɛ r a k
чалавецтва	t͡ʂ a ɫ a vʲ ɛ t͡s t v a
вызубіць	v ɨ z u bʲ i t͡sʲ
поначы	p ɔ n a t͡ʂ ɨ
аступіць	a s t u pʲ i t͡sʲ
прысмакі	p r ɨ s m a kʲ i
выбівачка	v ɨ bʲ i v a t͡ʂ k a
аксамітка	a k s a mʲ i t k a
хроснік	x r ɔ sʲ nʲ i k
безгаспадбрлівасць	bʲ ɛ z ɣ a s p a d b r lʲ i v a sʲ t͡sʲ
з’явішча	z j a vʲ i ʂ t͡ʂ a
цяжар	t͡sʲ a ʐ a r
падхадзіцца	p a d x a d͡zʲ i t͡sː a
алешнік	a lʲ ɛ ʂ nʲ i k
сцвярджэнне	sʲ t͡sʲ vʲ a r d ʐ ɛ nʲː ɛ
домаўладальнік	d ɔ m a w ɫ a d a lʲ nʲ i k
сузіральнік	s u zʲ i r a lʲ nʲ i k
ніякавець	nʲ i j a k a vʲ ɛ t͡sʲ
распаўсюдзіць	r a s p a w sʲ u d͡zʲ i t͡sʲ
сена	sʲ ɛ n a
імчанне	i m t͡ʂ a nʲː ɛ
дзявоцкі	d͡zʲ a v ɔ t͡s kʲ i
светаўспрыманне	sʲ vʲ ɛ t a w s p r ɨ m a nʲː ɛ
змякчальнік	zʲ mʲ a k t͡ʂ a lʲ nʲ i k
гніляк	ɣ nʲ i lʲ a k
астудзіць	a s t u d͡zʲ i t͡sʲ
стома	s t ɔ m a
зацвісці	z a t͡sʲ vʲ i sʲ t͡sʲ i
бамбасховішча	b a m b a s x ɔ vʲ i ʂ t͡ʂ a
пстрычка	p s t r ɨ t͡ʂ k a
перон	pʲ ɛ r ɔ n
услых	u s ɫ ɨ x
прысачыць	p r ɨ s a t͡ʂ ɨ t͡sʲ
пацерка	p a t͡sʲ ɛ r k a
прыстойны	p r ɨ s t ɔ j n ɨ
порсткі	p ɔ r s t kʲ i
імгла	i m ɣ ɫ a
дзівосны	d͡zʲ i v ɔ s n ɨ
уздужаць	u z d u ʐ a t͡sʲ
стрэліць	s t r ɛ lʲ i t͡sʲ
сыкнуць	s ɨ k n u t͡sʲ
старонні	s t a r ɔ nʲː i
грачанішча	ɣ r a t͡ʂ a nʲ i ʂ t͡ʂ a
відавочнасць	vʲ i d a v ɔ t͡ʂ n a sʲ t͡sʲ
дадзяўбці	d a d͡zʲ a w b t͡sʲ i
раўнадушнасць	r a w n a d u ʂ n a sʲ t͡sʲ
засмуціць	z a s m u t͡sʲ i t͡sʲ
прыхадзень	p r ɨ x a d͡zʲ ɛ nʲ
захопніцкі	z a x ɔ p nʲ i t͡s kʲ i
пераагляд	pʲ ɛ r a a ɣ lʲ a d
выкрывальнік	v ɨ k r ɨ v a lʲ nʲ i k
ніколі	nʲ i k ɔ lʲ i
бакоўка	b a k ɔ w k a
малапажыўны	m a ɫ a p a ʐ ɨ w n ɨ
засівераць	z a sʲ i vʲ ɛ r a t͡sʲ
удзельнік	u d͡zʲ ɛ lʲ nʲ i k
сшатраваць	s ʂ a t r a v a t͡sʲ
далупіць	d a ɫ u pʲ i t͡sʲ
жаўтаскуры	ʐ a w t a s k u r ɨ
светлавы	sʲ vʲ ɛ t ɫ a v ɨ
расшастать	r a s ʂ a s t a tʲ
ціхамірны	t͡sʲ i x a mʲ i r n ɨ
гутнік	ɣ u t nʲ i k
правапарушальнік	p r a v a p a r u ʂ a lʲ nʲ i k
вывандзіць	v ɨ v a n d͡zʲ i t͡sʲ
запрамяніцца	z a p r a mʲ a nʲ i t͡sː a
убранне	u b r a nʲː ɛ
звілісты	zʲ vʲ i lʲ i s t ɨ
стагоддзе	s t a ɣ ɔ d͡zʲː ɛ
каляіна	k a lʲ a j i n a
стрыжань	s t r ɨ ʐ a nʲ
напамін	n a p a mʲ i n
папрасаваць	p a p r a s a v a t͡sʲ
увышыню	u v ɨ ʂ ɨ nʲ u
перавітацца	pʲ ɛ r a vʲ i t a t͡sː a
аздараўленчы	a z d a r a w lʲ ɛ n t͡ʂ ɨ
склюд	s k lʲ u d
схамянуцца	s x a mʲ a n u t͡sː a
патураць	p a t u r a t͡sʲ
сівераць	sʲ i vʲ ɛ r a t͡sʲ
індычнік	i n d ɨ t͡ʂ nʲ i k
халадэча	x a ɫ a d ɛ t͡ʂ a
стварэнне	s t v a r ɛ nʲː ɛ
паўкрок	p a w k r ɔ k
разынкі	r a z ɨ n kʲ i
лявоніха	lʲ a v ɔ nʲ i x a
прасцяком	p r a sʲ t͡sʲ a k ɔ m
фарсісты	f a r sʲ i s t ɨ
гадоўля	ɣ a d ɔ w lʲ a
пырскаўка	p ɨ r s k a w k a
укарчанець	u k a r t͡ʂ a nʲ ɛ t͡sʲ
многагадзінны	m n ɔ ɣ a ɣ a d͡zʲ i nː ɨ
развіднецца	r a zʲ vʲ i d nʲ ɛ t͡sː a
падскрэбці	p a d s k r ɛ b t͡sʲ i
абмалёўка	a b m a lʲ ɔ w k a
ветрарухавік	vʲ ɛ t r a r u x a vʲ i k
хворы	x v ɔ r ɨ
марнатравіць	m a r n a t r a vʲ i t͡sʲ
цыбук	t͡s ɨ b u k
адзіхацець	a d͡zʲ i x a t͡sʲ ɛ t͡sʲ
падпаліць	p a d p a lʲ i t͡sʲ
бязмоўны	bʲ a z m ɔ w n ɨ
куркоўка	k u r k ɔ w k a
расплюшчыць	r a s p lʲ u ʂ t͡ʂ ɨ t͡sʲ
фантан	f a n t a n
пацягаць	p a t͡sʲ a ɣ a t͡sʲ
сцяць	sʲ t͡sʲ a t͡sʲ
стайнік	s t a j nʲ i k
разгаласіцца	r a z ɣ a ɫ a sʲ i t͡sː a
размалаціць	r a z m a ɫ a t͡sʲ i t͡sʲ
прыкласці	p r ɨ k ɫ a sʲ t͡sʲ i
перамалёўка	pʲ ɛ r a m a lʲ ɔ w k a
адасобіць	a d a s ɔ bʲ i t͡sʲ
настойлівы	n a s t ɔ j lʲ i v ɨ
аксаміт	a k s a mʲ i t
спрэс	s p r ɛ s
вадаёмісты	v a d a j ɔ mʲ i s t ɨ
паўтрызненне	p a w t r ɨ zʲ nʲ ɛ nʲː ɛ
падклікаць	p a d k lʲ i k a t͡sʲ
прыгук	p r ɨ ɣ u k
лёгкаўзгаральны	lʲ ɔ ɣ k a w z ɣ a r a lʲ n ɨ
рабаціць	r a b a t͡sʲ i t͡sʲ
разнастаіць	r a z n a s t a j i t͡sʲ
заўпарціцца	z a w p a r t͡sʲ i t͡sː a
радыёхваля	r a d ɨ j ɔ x v a lʲ a
падтаўчы	p a d t a w t͡ʂ ɨ
вынайсці	v ɨ n a j sʲ t͡sʲ i
коўзкі	k ɔ w z kʲ i
гізаваць	ɣʲ i z a v a t͡sʲ
пасірацець	p a sʲ i r a t͡sʲ ɛ t͡sʲ
утаймавальнік	u t a j m a v a lʲ nʲ i k
смяротнік	sʲ mʲ a r ɔ t nʲ i k
добразычлівы	d ɔ b r a z ɨ t͡ʂ lʲ i v ɨ
поўдзень	p ɔ w d͡zʲ ɛ nʲ
зніч	zʲ nʲ i t͡ʂ
памяць	p a mʲ a t͡sʲ
угрузнуць	u ɣ r u z n u t͡sʲ
самавыхаванне	s a m a v ɨ x a v a nʲː ɛ
самаспакушэнне	s a m a s p a k u ʂ ɛ nʲː ɛ
пераўтварэнне	pʲ ɛ r a w t v a r ɛ nʲː ɛ
шлейкі	ʂ lʲ ɛ j kʲ i
ужываны	u ʐ ɨ v a n ɨ
злітаваць	zʲ lʲ i t a v a t͡sʲ
цікавіць	t͡sʲ i k a vʲ i t͡sʲ
адсапціся	a d s a p t͡sʲ i sʲ a
папахадзіць	p a p a x a d͡zʲ i t͡sʲ
паўстаць	p a w s t a t͡sʲ
пралупіць	p r a ɫ u pʲ i t͡sʲ
наўсцяж	n a w sʲ t͡sʲ a ʐ
запазніцца	z a p a zʲ nʲ i t͡sː a
прылазнік	p r ɨ ɫ a zʲ nʲ i k
узрадавацца	u z r a d a v a t͡sː a
разбуйніць	r a z b u j nʲ i t͡sʲ
бессядзібны	bʲ ɛ sʲː a d͡zʲ i b n ɨ
шаткоўня	ʂ a t k ɔ w nʲ a
акалічнасць	a k a lʲ i t͡ʂ n a sʲ t͡sʲ
апаліць	a p a lʲ i t͡sʲ
счарсцвець	s t͡ʂ a r sʲ t͡sʲ vʲ ɛ t͡sʲ
сярнічка	sʲ a r nʲ i t͡ʂ k a
трава	t r a v a
ускруціцца	u s k r u t͡sʲ i t͡sː a
суладны	s u ɫ a d n ɨ
разнаколерны	r a z n a k ɔ lʲ ɛ r n ɨ
пазніцца	p a zʲ nʲ i t͡sː a
цвік	t͡sʲ vʲ i k
пустазелле	p u s t a zʲ ɛ lʲ lʲ ʲ ɛ
гатоўка	ɣ a t ɔ w k a
пакалмаціць	p a k a ɫ m a t͡sʲ i t͡sʲ
процідзейнічаць	p r ɔ t͡sʲ i d͡zʲ ɛ j nʲ i t͡ʂ a t͡sʲ
зацікавіць	z a t͡sʲ i k a vʲ i t͡sʲ
стрывожыць	s t r ɨ v ɔ ʐ ɨ t͡sʲ
тарка	t a r k a
знешні	zʲ nʲ ɛ ʂ nʲ i
парахаваць	p a r a x a v a t͡sʲ
прысады	p r ɨ s a d ɨ
паштовы	p a ʂ t ɔ v ɨ
адрадзіць	a d r a d͡zʲ i t͡sʲ
прыпадабненне	p r ɨ p a d a b nʲ ɛ nʲː ɛ
пасвярбець	p a sʲ vʲ a r bʲ ɛ t͡sʲ
пазакілзваць	p a z a kʲ i ɫ z v a t͡sʲ
пасмагнуць	p a s m a ɣ n u t͡sʲ
абвесці	a b vʲ ɛ sʲ t͡sʲ i
коўдра	k ɔ w d r a
паходзіць	p a x ɔ d͡zʲ i t͡sʲ
ускідаць	u s kʲ i d a t͡sʲ
селядзёўка	sʲ ɛ lʲ a d͡zʲ ɔ w k a
абясшкодзіць	a bʲ a s ʂ k ɔ d͡zʲ i t͡sʲ
аднаўленчы	a d n a w lʲ ɛ n t͡ʂ ɨ
перабіўка	pʲ ɛ r a bʲ i w k a
прасціна	p r a sʲ t͡sʲ i n a
вачніца	v a t͡ʂ nʲ i t͡s a
спазнацца	s p a z n a t͡sː a
выклінаць	v ɨ k lʲ i n a t͡sʲ
трапіцца	t r a pʲ i t͡sː a
пасаскрабаць	p a s a s k r a b a t͡sʲ
парабаваць	p a r a b a v a t͡sʲ
сувой	s u v ɔ j
увярцець	u vʲ a r t͡sʲ ɛ t͡sʲ
памяркоўны	p a mʲ a r k ɔ w n ɨ
ажыццявіць	a ʐ ɨ t͡sʲː a vʲ i t͡sʲ
сапраўды	s a p r a w d ɨ
выкпіць	v ɨ k pʲ i t͡sʲ
прыдрукаваць	p r ɨ d r u k a v a t͡sʲ
усходні	u s x ɔ d nʲ i
паслізнуцца	p a sʲ lʲ i z n u t͡sː a
пазайздросціць	p a z a j z d r ɔ sʲ t͡sʲ i t͡sʲ
ахрысціць	a x r ɨ sʲ t͡sʲ i t͡sʲ
домаўласнік	d ɔ m a w ɫ a sʲ nʲ i k
узбагаціць	u z b a ɣ a t͡sʲ i t͡sʲ
апошні	a p ɔ ʂ nʲ i
прыараць	p r ɨ a r a t͡sʲ
бурклівы	b u r k lʲ i v ɨ
прадракальнік	p r a d r a k a lʲ nʲ i k
размоўнік	r a z m ɔ w nʲ i k
пассядацца	p a sʲː a d a t͡sː a
юнацтва	j u n a t͡s t v a
прахарчавацца	p r a x a r t͡ʂ a v a t͡sː a
акісляльнік	a kʲ i sʲ lʲ a lʲ nʲ i k
галіна	ɣ a lʲ i n a
небезвыніковы	nʲ ɛ bʲ ɛ z v ɨ nʲ i k ɔ v ɨ
задзірына	z a d͡zʲ i r ɨ n a
наравісты	n a r a vʲ i s t ɨ
чуцца	t͡ʂ u t͡sː a
упэцкаць	u p ɛ t͡s k a t͡sʲ
напаўпразрысты	n a p a w p r a z r ɨ s t ɨ
ліха	lʲ i x a
прыскокнуць	p r ɨ s k ɔ k n u t͡sʲ
крохкі	k r ɔ x kʲ i
пярэціск	pʲ a r ɛ t͡sʲ i s k
вандроўны	v a n d r ɔ w n ɨ
продак	p r ɔ d a k
свярбячка	sʲ vʲ a r bʲ a t͡ʂ k a
змірыць	zʲ mʲ i r ɨ t͡sʲ
абгінаць	a b ɣʲ i n a t͡sʲ
шэраг	ʂ ɛ r a ɣ
абставіны	a b s t a vʲ i n ɨ
кіраўнік	kʲ i r a w nʲ i k
угамаваць	u ɣ a m a v a t͡sʲ
згадзіць	z ɣ a d͡zʲ i t͡sʲ
віншаваць	vʲ i n ʂ a v a t͡sʲ
пудзіць	p u d͡zʲ i t͡sʲ
безназоўны	bʲ ɛ z n a z ɔ w n ɨ
пераемнасць	pʲ ɛ r a j ɛ m n a sʲ t͡sʲ
прылатаць	p r ɨ ɫ a t a t͡sʲ
зашчапіць	z a ʂ t͡ʂ a pʲ i t͡sʲ
паліва	p a lʲ i v a
льнянішча	lʲ nʲ a nʲ i ʂ t͡ʂ a
прамяністы	p r a mʲ a nʲ i s t ɨ
прынадзіць	p r ɨ n a d͡zʲ i t͡sʲ
залішне	z a lʲ i ʂ nʲ ɛ
удзірванець	u d͡zʲ i r v a nʲ ɛ t͡sʲ
палуднаваць	p a ɫ u d n a v a t͡sʲ
пакора	p a k ɔ r a
чагосьці	t͡ʂ a ɣ ɔ sʲ t͡sʲ i
плешка	p lʲ ɛ ʂ k a
згушчальнік	z ɣ u ʂ t͡ʂ a lʲ nʲ i k
проціяддзе	p r ɔ t͡sʲ i j a d͡zʲː ɛ
спасвіць	s p a sʲ vʲ i t͡sʲ
пакідзішча	p a kʲ i d͡zʲ i ʂ t͡ʂ a
чужына	t͡ʂ u ʐ ɨ n a
перабіранка	pʲ ɛ r a bʲ i r a n k a
ржаўнік	r ʐ a w nʲ i k
упыніць	u p ɨ nʲ i t͡sʲ
памацніць	p a m a t͡sʲ nʲ i t͡sʲ
апладніць	a p ɫ a d nʲ i t͡sʲ
цепліць	t͡sʲ ɛ p lʲ i t͡sʲ
туляцца	t u lʲ a t͡sː a
прасцяг	p r a sʲ t͡sʲ a ɣ
усходкі	u s x ɔ d kʲ i
патрымаць	p a t r ɨ m a t͡sʲ
строі	s t r ɔ j i
прачулы	p r a t͡ʂ u ɫ ɨ
ускудлаціць	u s k u d ɫ a t͡sʲ i t͡sʲ
аўтабудаванне	a w t a b u d a v a nʲː ɛ
выкрадальнік	v ɨ k r a d a lʲ nʲ i k
сумяшчальнік	s u mʲ a ʂ t͡ʂ a lʲ nʲ i k
расшыральнік	r a s ʂ ɨ r a lʲ nʲ i k
мінуўшчына	mʲ i n u w ʂ t͡ʂ ɨ n a
пярэдадзень	pʲ a r ɛ d a d͡zʲ ɛ nʲ
верхавіна	vʲ ɛ r x a vʲ i n a
схаваць	s x a v a t͡sʲ
шматок	ʂ m a t ɔ k
шэпт	ʂ ɛ p t
даўжыня	d a w ʐ ɨ nʲ a
някемлівы	nʲ a kʲ ɛ m lʲ i v ɨ
выпінаць	v ɨ pʲ i n a t͡sʲ
пераараць	pʲ ɛ r a a r a t͡sʲ
упільнаваць	u pʲ i lʲ n a v a t͡sʲ
узлавацца	u z ɫ a v a t͡sː a
цурбак	t͡s u r b a k
скнара	s k n a r a
бародаўка	b a r ɔ d a w k a
малапраўдзівы	m a ɫ a p r a w d͡zʲ i v ɨ
забаламуціць	z a b a ɫ a m u t͡sʲ i t͡sʲ
прывітанне	p r ɨ vʲ i t a nʲː ɛ
цяжэць	t͡sʲ a ʐ ɛ t͡sʲ
таваразнаўства	t a v a r a z n a w s t v a
палаяцца	p a ɫ a j a t͡sː a
выкід	v ɨ kʲ i d
сэнс	s ɛ n s
урадлівы	u r a d lʲ i v ɨ
даўгатвары	d a w ɣ a t v a r ɨ
ціша	t͡sʲ i ʂ a
прарухацца	p r a r u x a t͡sː a
тады-сяды	t a d ɨ - sʲ a d ɨ
складаць	s k ɫ a d a t͡sʲ
выносісты	v ɨ n ɔ sʲ i s t ɨ
прыцямнець	p r ɨ t͡sʲ a m nʲ ɛ t͡sʲ
узадраць	u z a d r a t͡sʲ
растуліць	r a s t u lʲ i t͡sʲ
рахаваць	r a x a v a t͡sʲ
напамінак	n a p a mʲ i n a k
гасцінец	ɣ a sʲ t͡sʲ i nʲ ɛ t͡s
вогнішча	v ɔ ɣ nʲ i ʂ t͡ʂ a
адквітаць	a d k vʲ i t a t͡sʲ
неадхільны	nʲ ɛ a d xʲ i lʲ n ɨ
папазніцца	p a p a zʲ nʲ i t͡sː a
забруіцца	z a b r u j i t͡sː a
вітаць	vʲ i t a t͡sʲ
шматлікі	ʂ m a t lʲ i kʲ i
мусіць	m u sʲ i t͡sʲ
ворлікі	v ɔ r lʲ i kʲ i
прымеркаваць	p r ɨ mʲ ɛ r k a v a t͡sʲ
схіліць	s xʲ i lʲ i t͡sʲ
чмыхнуць	t͡ʂ m ɨ x n u t͡sʲ
розны	r ɔ z n ɨ
серабро	sʲ ɛ r a b r ɔ
скураміт	s k u r a mʲ i t
прываліць	p r ɨ v a lʲ i t͡sʲ
парасшморгваць	p a r a s ʂ m ɔ r ɣ v a t͡sʲ
дамавіна	d a m a vʲ i n a
скрыгануць	s k r ɨ ɣ a n u t͡sʲ
прыродны	p r ɨ r ɔ d n ɨ
пасцёбаць	p a sʲ t͡sʲ ɔ b a t͡sʲ
прапражыць	p r a p r a ʐ ɨ t͡sʲ
ваяўнік	v a j a w nʲ i k
сітавеялка	sʲ i t a vʲ ɛ j a ɫ k a
наўзбоч	n a w z b ɔ t͡ʂ
папрыкручваць	p a p r ɨ k r u t͡ʂ v a t͡sʲ
чаўпці	t͡ʂ a w p t͡sʲ i
прыбудова	p r ɨ b u d ɔ v a
суцэльны	s u t͡s ɛ lʲ n ɨ
ускраіна	u s k r a j i n a
паўаркуш	p a w a r k u ʂ
смагнуць	s m a ɣ n u t͡sʲ
узорысты	u z ɔ r ɨ s t ɨ
убегчы	u bʲ ɛ ɣ t͡ʂ ɨ
дойлід	d ɔ j lʲ i d
стаўчы	s t a w t͡ʂ ɨ
бяскрыўдны	bʲ a s k r ɨ w d n ɨ
вялізны	vʲ a lʲ i z n ɨ
агаліць	a ɣ a lʲ i t͡sʲ
злазіць	z ɫ a zʲ i t͡sʲ
заступіць	z a s t u pʲ i t͡sʲ
скараціць	s k a r a t͡sʲ i t͡sʲ
капыціць	k a p ɨ t͡sʲ i t͡sʲ
слушнасць	s ɫ u ʂ n a sʲ t͡sʲ
запальнічка	z a p a lʲ nʲ i t͡ʂ k a
гарбузнік	ɣ a r b u zʲ nʲ i k
прахапіцца	p r a x a pʲ i t͡sː a
прыгажуня	p r ɨ ɣ a ʐ u nʲ a
раскарміцца	r a s k a r mʲ i t͡sː a
драўняны	d r a w nʲ a n ɨ
пяцігодка	pʲ a t͡sʲ i ɣ ɔ d k a
золкі	z ɔ ɫ kʲ i
швэндацца	ʂ v ɛ n d a t͡sː a
жыўцом	ʐ ɨ w t͡s ɔ m
продаж	p r ɔ d a ʐ
выпілаваць	v ɨ pʲ i ɫ a v a t͡sʲ
успрыняць	u s p r ɨ nʲ a t͡sʲ
фатаграфаваць	f a t a ɣ r a f a v a t͡sʲ
прыменшыць	p r ɨ mʲ ɛ n ʂ ɨ t͡sʲ
лічбаваць	lʲ i t͡ʂ b a v a t͡sʲ
дзікун	d͡zʲ i k u n
назнаходзіць	n a z n a x ɔ d͡zʲ i t͡sʲ
ёлкі	j ɔ ɫ kʲ i
кінуць	kʲ i n u t͡sʲ
назапасіць	n a z a p a sʲ i t͡sʲ
сшывальнік	s ʂ ɨ v a lʲ nʲ i k
жаўтазель	ʐ a w t a zʲ ɛ lʲ
цаляць	t͡s a lʲ a t͡sʲ
крыніца	k r ɨ nʲ i t͡s a
поплаў	p ɔ p ɫ a w
аліва	a lʲ i v a
прачуць	p r a t͡ʂ u t͡sʲ
хапіць	x a pʲ i t͡sʲ
мячэўнік	mʲ a t͡ʂ ɛ w nʲ i k
пашмараваць	p a ʂ m a r a v a t͡sʲ
расхінуць	r a s xʲ i n u t͡sʲ
злучальнік	z ɫ u t͡ʂ a lʲ nʲ i k
атруціць	a t r u t͡sʲ i t͡sʲ
чапля	t͡ʂ a p lʲ a
каласоўнік	k a ɫ a s ɔ w nʲ i k
аўтавымяральны	a w t a v ɨ mʲ a r a lʲ n ɨ
вятроўнік	vʲ a t r ɔ w nʲ i k
міжвольны	mʲ i ʐ v ɔ lʲ n ɨ
прыскок	p r ɨ s k ɔ k
заліхвацкі	z a lʲ i x v a t͡s kʲ i
чаравікі	t͡ʂ a r a vʲ i kʲ i
хлусіць	x ɫ u sʲ i t͡sʲ
успамін	u s p a mʲ i n
ухіліцца	u xʲ i lʲ i t͡sː a
руплівец	r u p lʲ i vʲ ɛ t͡s
папакутаваць	p a p a k u t a v a t͡sʲ
ашкліць	a ʂ k lʲ i t͡sʲ
прымроіцца	p r ɨ m r ɔ j i t͡sː a
схапіцца	s x a pʲ i t͡sː a
прочкі	p r ɔ t͡ʂ kʲ i
падзічэць	p a d͡zʲ i t͡ʂ ɛ t͡sʲ
выпраменіць	v ɨ p r a mʲ ɛ nʲ i t͡sʲ
загушчальнік	z a ɣ u ʂ t͡ʂ a lʲ nʲ i k
безліч	bʲ ɛ zʲ lʲ i t͡ʂ
узбярэжжа	u zʲ bʲ a r ɛ ʐ ʐ a
замілаванне	z a mʲ i ɫ a v a nʲː ɛ
чаротніца	t͡ʂ a r ɔ t nʲ i t͡s a
стаў	s t a w
перавэндзіць	pʲ ɛ r a v ɛ n d͡zʲ i t͡sʲ
домакіраўнік	d ɔ m a kʲ i r a w nʲ i k
службовец	s ɫ u ʐ b ɔ vʲ ɛ t͡s
звіліна	zʲ vʲ i lʲ i n a
прахарчаваць	p r a x a r t͡ʂ a v a t͡sʲ
разлупіць	r a z ɫ u pʲ i t͡sʲ
параспранаць	p a r a s p r a n a t͡sʲ
ванітаваць	v a nʲ i t a v a t͡sʲ
утрапёнасць	u t r a pʲ ɔ n a sʲ t͡sʲ
напаўзаплюшчаны	n a p a w z a p lʲ u ʂ t͡ʂ a n ɨ
дыхтоўны	d ɨ x t ɔ w n ɨ
усё	u sʲ ɔ
вынікнуць	v ɨ nʲ i k n u t͡sʲ
прамармытаць	p r a m a r m ɨ t a t͡sʲ
павелічальнік	p a vʲ ɛ lʲ i t͡ʂ a lʲ nʲ i k
пападзьмухаць	p a p a d zʲ m u x a t͡sʲ
